utilA;utilB;utilSum;contract;index;pareto
2094;7297;9391;[50,172,12,22,26,178,147,3,2,130,84,117,77,112,109,118,66,157,103,105,74,188,93,31,6,87,167,61,45,138,41,49,78,128,42,57,37,121,162,126,143,160,91,1,33,124,94,196,36,182,140,92,82,23,189,81,0,85,104,20,146,193,9,144,170,95,38,139,19,46,51,149,34,194,180,123,176,67,32,72,163,25,70,65,16,190,11,113,156,71,165,184,174,8,173,18,131,110,101,59,80,100,30,134,148,195,97,58,175,151,7,191,181,68,198,142,137,158,54,52,119,187,39,107,55,14,13,111,132,89,75,4,15,135,53,183,69,159,164,90,28,155,73,99,106,136,115,152,35,161,102,86,133,76,122,116,44,125,145,56,21,108,192,40,169,129,29,154,60,177,27,43,127,96,171,141,98,114,64,79,179,47,88,5,186,199,83,153,166,24,150,10,185,62,120,197,168,17,48,63];0;True
1586;8596;10182;[189,49,102,122,114,3,2,129,72,105,99,73,140,178,192,10,123,17,8,94,173,18,25,120,24,197,15,9,150,143,67,60,147,65,124,142,130,22,38,21,135,14,75,151,7,153,187,127,39,107,101,76,50,53,93,27,30,134,58,86,181,82,23,12,54,158,121,168,117,98,78,110,81,52,106,118,183,83,26,79,185,148,167,61,59,36,46,5,41,133,96,157,138,45,188,87,66,126,198,159,174,1,51,29,154,156,160,71,69,190,43,128,85,164,111,88,40,37,145,139,33,13,172,195,182,109,141,35,6,56,92,194,31,171,152,57,186,113,196,89,162,146,28,74,4,97,131,0,199,62,44,34,108,20,55,155,184,161,80,137,177,169,191,11,104,180,163,170,95,91,90,125,149,32,68,63,100,116,175,165,193,16,136,144,70,19,64,103,112,84,77,115,179,176,42,47,132,166,119,48];1;True
1784;8595;10379;[160,102,49,122,114,3,2,129,72,105,99,73,140,178,192,10,123,17,8,94,173,18,25,120,24,197,15,9,150,143,67,60,147,65,124,142,130,22,38,21,135,14,75,151,7,153,187,127,39,107,101,76,50,53,93,27,30,134,58,86,181,82,23,12,54,158,121,168,117,98,78,110,81,52,106,118,183,83,26,79,185,148,167,61,59,36,46,5,41,133,96,157,138,45,188,87,66,126,198,159,174,1,51,29,154,156,92,71,69,190,43,128,85,164,111,88,40,37,145,139,33,13,172,195,182,109,141,35,6,56,189,194,31,171,152,57,186,113,196,89,162,146,28,74,4,97,131,0,199,62,44,34,108,20,55,155,184,161,80,137,177,169,191,11,104,180,163,170,95,91,90,125,149,32,68,63,100,116,175,165,193,16,136,144,70,19,64,103,112,84,77,115,179,176,42,47,132,166,119,48];2;False
2243;7293;9536;[92,172,12,22,26,178,147,3,2,130,84,117,77,112,109,118,66,157,103,105,74,188,93,31,6,87,167,61,45,138,41,49,78,128,42,57,37,121,162,126,143,160,91,1,33,124,94,196,36,182,140,50,82,23,189,81,0,85,104,20,146,193,9,144,170,95,38,139,19,46,51,149,34,194,180,123,176,67,32,72,163,25,70,65,16,190,11,113,156,71,165,184,174,8,173,18,131,110,101,59,80,100,30,134,148,195,97,58,175,151,7,191,181,68,198,142,137,158,54,52,119,187,39,107,55,14,13,111,132,89,75,4,15,135,53,183,69,159,164,90,28,155,73,99,106,136,115,152,35,161,102,86,133,76,122,116,44,125,145,56,21,108,192,40,169,129,29,154,60,177,27,43,127,96,171,141,98,114,64,79,179,47,88,5,186,199,83,153,166,24,150,10,185,62,120,197,168,17,48,63];3;False
1684;8591;10275;[49,189,102,122,114,3,2,129,72,105,99,73,140,178,192,10,123,17,8,94,173,18,25,120,24,197,15,9,150,143,67,60,147,65,124,142,130,22,38,21,135,14,75,151,7,153,187,127,39,107,101,76,50,53,93,27,30,134,58,86,181,82,23,12,54,158,121,168,117,98,78,110,81,52,106,118,183,83,26,79,185,148,167,61,59,36,46,5,41,133,96,157,138,45,188,87,66,126,198,159,174,1,51,29,154,156,160,71,69,190,43,128,85,164,111,88,40,37,145,139,33,13,172,195,182,109,141,35,6,56,92,194,31,171,152,57,186,113,196,89,162,146,28,74,4,97,131,0,199,62,44,34,108,20,55,155,184,161,80,137,177,169,191,11,104,180,163,170,95,91,90,125,149,32,68,63,100,116,175,165,193,16,136,144,70,19,64,103,112,84,77,115,179,176,42,47,132,166,119,48];4;False
1670;8583;10253;[102,49,189,122,114,3,2,129,72,105,99,73,140,178,192,10,123,17,8,94,173,18,25,120,24,197,15,9,150,143,67,60,147,65,124,142,130,22,38,21,135,14,75,151,7,153,187,127,39,107,101,76,50,53,93,27,30,134,58,86,181,82,23,12,54,158,121,168,117,98,78,110,81,52,106,118,183,83,26,79,185,148,167,61,59,36,46,5,41,133,96,157,138,45,188,87,66,126,198,159,174,1,51,29,154,156,160,71,69,190,43,128,85,164,111,88,40,37,145,139,33,13,172,195,182,109,141,35,6,56,92,194,31,171,152,57,186,113,196,89,162,146,28,74,4,97,131,0,199,62,44,34,108,20,55,155,184,161,80,137,177,169,191,11,104,180,163,170,95,91,90,125,149,32,68,63,100,116,175,165,193,16,136,144,70,19,64,103,112,84,77,115,179,176,42,47,132,166,119,48];5;True
2401;7283;9684;[149,172,12,22,26,178,147,3,2,130,84,117,77,112,109,118,66,157,103,105,74,188,93,31,6,87,167,61,45,138,41,49,78,128,42,57,37,121,162,126,143,160,91,1,33,124,94,196,36,182,140,50,82,23,189,81,0,85,104,20,146,193,9,144,170,95,38,139,19,46,51,92,34,194,180,123,176,67,32,72,163,25,70,65,16,190,11,113,156,71,165,184,174,8,173,18,131,110,101,59,80,100,30,134,148,195,97,58,175,151,7,191,181,68,198,142,137,158,54,52,119,187,39,107,55,14,13,111,132,89,75,4,15,135,53,183,69,159,164,90,28,155,73,99,106,136,115,152,35,161,102,86,133,76,122,116,44,125,145,56,21,108,192,40,169,129,29,154,60,177,27,43,127,96,171,141,98,114,64,79,179,47,88,5,186,199,83,153,166,24,150,10,185,62,120,197,168,17,48,63];6;False
1873;8566;10439;[143,49,189,122,114,3,2,129,72,105,99,73,140,178,192,10,123,17,8,94,173,18,25,120,24,197,15,9,150,102,67,60,147,65,124,142,130,22,38,21,135,14,75,151,7,153,187,127,39,107,101,76,50,53,93,27,30,134,58,86,181,82,23,12,54,158,121,168,117,98,78,110,81,52,106,118,183,83,26,79,185,148,167,61,59,36,46,5,41,133,96,157,138,45,188,87,66,126,198,159,174,1,51,29,154,156,160,71,69,190,43,128,85,164,111,88,40,37,145,139,33,13,172,195,182,109,141,35,6,56,92,194,31,171,152,57,186,113,196,89,162,146,28,74,4,97,131,0,199,62,44,34,108,20,55,155,184,161,80,137,177,169,191,11,104,180,163,170,95,91,90,125,149,32,68,63,100,116,175,165,193,16,136,144,70,19,64,103,112,84,77,115,179,176,42,47,132,166,119,48];7;False
2452;7277;9729;[147,172,12,22,26,178,149,3,2,130,84,117,77,112,109,118,66,157,103,105,74,188,93,31,6,87,167,61,45,138,41,49,78,128,42,57,37,121,162,126,143,160,91,1,33,124,94,196,36,182,140,50,82,23,189,81,0,85,104,20,146,193,9,144,170,95,38,139,19,46,51,92,34,194,180,123,176,67,32,72,163,25,70,65,16,190,11,113,156,71,165,184,174,8,173,18,131,110,101,59,80,100,30,134,148,195,97,58,175,151,7,191,181,68,198,142,137,158,54,52,119,187,39,107,55,14,13,111,132,89,75,4,15,135,53,183,69,159,164,90,28,155,73,99,106,136,115,152,35,161,102,86,133,76,122,116,44,125,145,56,21,108,192,40,169,129,29,154,60,177,27,43,127,96,171,141,98,114,64,79,179,47,88,5,186,199,83,153,166,24,150,10,185,62,120,197,168,17,48,63];8;False
1843;8565;10408;[142,49,189,122,114,3,2,129,72,105,99,73,140,178,192,10,123,17,8,94,173,18,25,120,24,197,15,9,150,102,67,60,147,65,124,143,130,22,38,21,135,14,75,151,7,153,187,127,39,107,101,76,50,53,93,27,30,134,58,86,181,82,23,12,54,158,121,168,117,98,78,110,81,52,106,118,183,83,26,79,185,148,167,61,59,36,46,5,41,133,96,157,138,45,188,87,66,126,198,159,174,1,51,29,154,156,160,71,69,190,43,128,85,164,111,88,40,37,145,139,33,13,172,195,182,109,141,35,6,56,92,194,31,171,152,57,186,113,196,89,162,146,28,74,4,97,131,0,199,62,44,34,108,20,55,155,184,161,80,137,177,169,191,11,104,180,163,170,95,91,90,125,149,32,68,63,100,116,175,165,193,16,136,144,70,19,64,103,112,84,77,115,179,176,42,47,132,166,119,48];9;False
2452;7266;9718;[31,172,12,22,26,178,149,3,2,130,84,117,77,112,109,118,66,157,103,105,74,188,93,147,6,87,167,61,45,138,41,49,78,128,42,57,37,121,162,126,143,160,91,1,33,124,94,196,36,182,140,50,82,23,189,81,0,85,104,20,146,193,9,144,170,95,38,139,19,46,51,92,34,194,180,123,176,67,32,72,163,25,70,65,16,190,11,113,156,71,165,184,174,8,173,18,131,110,101,59,80,100,30,134,148,195,97,58,175,151,7,191,181,68,198,142,137,158,54,52,119,187,39,107,55,14,13,111,132,89,75,4,15,135,53,183,69,159,164,90,28,155,73,99,106,136,115,152,35,161,102,86,133,76,122,116,44,125,145,56,21,108,192,40,169,129,29,154,60,177,27,43,127,96,171,141,98,114,64,79,179,47,88,5,186,199,83,153,166,24,150,10,185,62,120,197,168,17,48,63];10;False
1812;8582;10394;[189,49,142,122,114,3,2,129,72,105,99,73,140,178,192,10,123,17,8,94,173,18,25,120,24,197,15,9,150,102,67,60,147,65,124,143,130,22,38,21,135,14,75,151,7,153,187,127,39,107,101,76,50,53,93,27,30,134,58,86,181,82,23,12,54,158,121,168,117,98,78,110,81,52,106,118,183,83,26,79,185,148,167,61,59,36,46,5,41,133,96,157,138,45,188,87,66,126,198,159,174,1,51,29,154,156,160,71,69,190,43,128,85,164,111,88,40,37,145,139,33,13,172,195,182,109,141,35,6,56,92,194,31,171,152,57,186,113,196,89,162,146,28,74,4,97,131,0,199,62,44,34,108,20,55,155,184,161,80,137,177,169,191,11,104,180,163,170,95,91,90,125,149,32,68,63,100,116,175,165,193,16,136,144,70,19,64,103,112,84,77,115,179,176,42,47,132,166,119,48];11;False
2413;7256;9669;[50,172,12,22,26,178,149,3,2,130,84,117,77,112,109,118,66,157,103,105,74,188,93,147,6,87,167,61,45,138,41,49,78,128,42,57,37,121,162,126,143,160,91,1,33,124,94,196,36,182,140,31,82,23,189,81,0,85,104,20,146,193,9,144,170,95,38,139,19,46,51,92,34,194,180,123,176,67,32,72,163,25,70,65,16,190,11,113,156,71,165,184,174,8,173,18,131,110,101,59,80,100,30,134,148,195,97,58,175,151,7,191,181,68,198,142,137,158,54,52,119,187,39,107,55,14,13,111,132,89,75,4,15,135,53,183,69,159,164,90,28,155,73,99,106,136,115,152,35,161,102,86,133,76,122,116,44,125,145,56,21,108,192,40,169,129,29,154,60,177,27,43,127,96,171,141,98,114,64,79,179,47,88,5,186,199,83,153,166,24,150,10,185,62,120,197,168,17,48,63];12;False
1964;8559;10523;[72,49,142,122,114,3,2,129,189,105,99,73,140,178,192,10,123,17,8,94,173,18,25,120,24,197,15,9,150,102,67,60,147,65,124,143,130,22,38,21,135,14,75,151,7,153,187,127,39,107,101,76,50,53,93,27,30,134,58,86,181,82,23,12,54,158,121,168,117,98,78,110,81,52,106,118,183,83,26,79,185,148,167,61,59,36,46,5,41,133,96,157,138,45,188,87,66,126,198,159,174,1,51,29,154,156,160,71,69,190,43,128,85,164,111,88,40,37,145,139,33,13,172,195,182,109,141,35,6,56,92,194,31,171,152,57,186,113,196,89,162,146,28,74,4,97,131,0,199,62,44,34,108,20,55,155,184,161,80,137,177,169,191,11,104,180,163,170,95,91,90,125,149,32,68,63,100,116,175,165,193,16,136,144,70,19,64,103,112,84,77,115,179,176,42,47,132,166,119,48];13;False
2378;7249;9627;[92,172,12,22,26,178,149,3,2,130,84,117,77,112,109,118,66,157,103,105,74,188,93,147,6,87,167,61,45,138,41,49,78,128,42,57,37,121,162,126,143,160,91,1,33,124,94,196,36,182,140,31,82,23,189,81,0,85,104,20,146,193,9,144,170,95,38,139,19,46,51,50,34,194,180,123,176,67,32,72,163,25,70,65,16,190,11,113,156,71,165,184,174,8,173,18,131,110,101,59,80,100,30,134,148,195,97,58,175,151,7,191,181,68,198,142,137,158,54,52,119,187,39,107,55,14,13,111,132,89,75,4,15,135,53,183,69,159,164,90,28,155,73,99,106,136,115,152,35,161,102,86,133,76,122,116,44,125,145,56,21,108,192,40,169,129,29,154,60,177,27,43,127,96,171,141,98,114,64,79,179,47,88,5,186,199,83,153,166,24,150,10,185,62,120,197,168,17,48,63];14;False
2029;8557;10586;[178,49,142,122,114,3,2,129,189,105,99,73,140,72,192,10,123,17,8,94,173,18,25,120,24,197,15,9,150,102,67,60,147,65,124,143,130,22,38,21,135,14,75,151,7,153,187,127,39,107,101,76,50,53,93,27,30,134,58,86,181,82,23,12,54,158,121,168,117,98,78,110,81,52,106,118,183,83,26,79,185,148,167,61,59,36,46,5,41,133,96,157,138,45,188,87,66,126,198,159,174,1,51,29,154,156,160,71,69,190,43,128,85,164,111,88,40,37,145,139,33,13,172,195,182,109,141,35,6,56,92,194,31,171,152,57,186,113,196,89,162,146,28,74,4,97,131,0,199,62,44,34,108,20,55,155,184,161,80,137,177,169,191,11,104,180,163,170,95,91,90,125,149,32,68,63,100,116,175,165,193,16,136,144,70,19,64,103,112,84,77,115,179,176,42,47,132,166,119,48];15;False
2326;7291;9617;[178,172,12,22,26,92,149,3,2,130,84,117,77,112,109,118,66,157,103,105,74,188,93,147,6,87,167,61,45,138,41,49,78,128,42,57,37,121,162,126,143,160,91,1,33,124,94,196,36,182,140,31,82,23,189,81,0,85,104,20,146,193,9,144,170,95,38,139,19,46,51,50,34,194,180,123,176,67,32,72,163,25,70,65,16,190,11,113,156,71,165,184,174,8,173,18,131,110,101,59,80,100,30,134,148,195,97,58,175,151,7,191,181,68,198,142,137,158,54,52,119,187,39,107,55,14,13,111,132,89,75,4,15,135,53,183,69,159,164,90,28,155,73,99,106,136,115,152,35,161,102,86,133,76,122,116,44,125,145,56,21,108,192,40,169,129,29,154,60,177,27,43,127,96,171,141,98,114,64,79,179,47,88,5,186,199,83,153,166,24,150,10,185,62,120,197,168,17,48,63];16;False
2072;8546;10618;[143,49,142,122,114,3,2,129,189,105,99,73,140,72,192,10,123,17,8,94,173,18,25,120,24,197,15,9,150,102,67,60,147,65,124,178,130,22,38,21,135,14,75,151,7,153,187,127,39,107,101,76,50,53,93,27,30,134,58,86,181,82,23,12,54,158,121,168,117,98,78,110,81,52,106,118,183,83,26,79,185,148,167,61,59,36,46,5,41,133,96,157,138,45,188,87,66,126,198,159,174,1,51,29,154,156,160,71,69,190,43,128,85,164,111,88,40,37,145,139,33,13,172,195,182,109,141,35,6,56,92,194,31,171,152,57,186,113,196,89,162,146,28,74,4,97,131,0,199,62,44,34,108,20,55,155,184,161,80,137,177,169,191,11,104,180,163,170,95,91,90,125,149,32,68,63,100,116,175,165,193,16,136,144,70,19,64,103,112,84,77,115,179,176,42,47,132,166,119,48];17;False
2344;7278;9622;[149,172,12,22,26,92,178,3,2,130,84,117,77,112,109,118,66,157,103,105,74,188,93,147,6,87,167,61,45,138,41,49,78,128,42,57,37,121,162,126,143,160,91,1,33,124,94,196,36,182,140,31,82,23,189,81,0,85,104,20,146,193,9,144,170,95,38,139,19,46,51,50,34,194,180,123,176,67,32,72,163,25,70,65,16,190,11,113,156,71,165,184,174,8,173,18,131,110,101,59,80,100,30,134,148,195,97,58,175,151,7,191,181,68,198,142,137,158,54,52,119,187,39,107,55,14,13,111,132,89,75,4,15,135,53,183,69,159,164,90,28,155,73,99,106,136,115,152,35,161,102,86,133,76,122,116,44,125,145,56,21,108,192,40,169,129,29,154,60,177,27,43,127,96,171,141,98,114,64,79,179,47,88,5,186,199,83,153,166,24,150,10,185,62,120,197,168,17,48,63];18;False
1869;8563;10432;[102,49,142,122,114,3,2,129,189,105,99,73,140,72,192,10,123,17,8,94,173,18,25,120,24,197,15,9,150,143,67,60,147,65,124,178,130,22,38,21,135,14,75,151,7,153,187,127,39,107,101,76,50,53,93,27,30,134,58,86,181,82,23,12,54,158,121,168,117,98,78,110,81,52,106,118,183,83,26,79,185,148,167,61,59,36,46,5,41,133,96,157,138,45,188,87,66,126,198,159,174,1,51,29,154,156,160,71,69,190,43,128,85,164,111,88,40,37,145,139,33,13,172,195,182,109,141,35,6,56,92,194,31,171,152,57,186,113,196,89,162,146,28,74,4,97,131,0,199,62,44,34,108,20,55,155,184,161,80,137,177,169,191,11,104,180,163,170,95,91,90,125,149,32,68,63,100,116,175,165,193,16,136,144,70,19,64,103,112,84,77,115,179,176,42,47,132,166,119,48];19;False
2333;7263;9596;[87,172,12,22,26,92,178,3,2,130,84,117,77,112,109,118,66,157,103,105,74,188,93,147,6,149,167,61,45,138,41,49,78,128,42,57,37,121,162,126,143,160,91,1,33,124,94,196,36,182,140,31,82,23,189,81,0,85,104,20,146,193,9,144,170,95,38,139,19,46,51,50,34,194,180,123,176,67,32,72,163,25,70,65,16,190,11,113,156,71,165,184,174,8,173,18,131,110,101,59,80,100,30,134,148,195,97,58,175,151,7,191,181,68,198,142,137,158,54,52,119,187,39,107,55,14,13,111,132,89,75,4,15,135,53,183,69,159,164,90,28,155,73,99,106,136,115,152,35,161,102,86,133,76,122,116,44,125,145,56,21,108,192,40,169,129,29,154,60,177,27,43,127,96,171,141,98,114,64,79,179,47,88,5,186,199,83,153,166,24,150,10,185,62,120,197,168,17,48,63];20;False
1816;8559;10375;[142,49,102,122,114,3,2,129,189,105,99,73,140,72,192,10,123,17,8,94,173,18,25,120,24,197,15,9,150,143,67,60,147,65,124,178,130,22,38,21,135,14,75,151,7,153,187,127,39,107,101,76,50,53,93,27,30,134,58,86,181,82,23,12,54,158,121,168,117,98,78,110,81,52,106,118,183,83,26,79,185,148,167,61,59,36,46,5,41,133,96,157,138,45,188,87,66,126,198,159,174,1,51,29,154,156,160,71,69,190,43,128,85,164,111,88,40,37,145,139,33,13,172,195,182,109,141,35,6,56,92,194,31,171,152,57,186,113,196,89,162,146,28,74,4,97,131,0,199,62,44,34,108,20,55,155,184,161,80,137,177,169,191,11,104,180,163,170,95,91,90,125,149,32,68,63,100,116,175,165,193,16,136,144,70,19,64,103,112,84,77,115,179,176,42,47,132,166,119,48];21;False
2516;7216;9732;[92,172,12,22,26,87,178,3,2,130,84,117,77,112,109,118,66,157,103,105,74,188,93,147,6,149,167,61,45,138,41,49,78,128,42,57,37,121,162,126,143,160,91,1,33,124,94,196,36,182,140,31,82,23,189,81,0,85,104,20,146,193,9,144,170,95,38,139,19,46,51,50,34,194,180,123,176,67,32,72,163,25,70,65,16,190,11,113,156,71,165,184,174,8,173,18,131,110,101,59,80,100,30,134,148,195,97,58,175,151,7,191,181,68,198,142,137,158,54,52,119,187,39,107,55,14,13,111,132,89,75,4,15,135,53,183,69,159,164,90,28,155,73,99,106,136,115,152,35,161,102,86,133,76,122,116,44,125,145,56,21,108,192,40,169,129,29,154,60,177,27,43,127,96,171,141,98,114,64,79,179,47,88,5,186,199,83,153,166,24,150,10,185,62,120,197,168,17,48,63];22;False
1933;8539;10472;[147,49,102,122,114,3,2,129,189,105,99,73,140,72,192,10,123,17,8,94,173,18,25,120,24,197,15,9,150,143,67,60,142,65,124,178,130,22,38,21,135,14,75,151,7,153,187,127,39,107,101,76,50,53,93,27,30,134,58,86,181,82,23,12,54,158,121,168,117,98,78,110,81,52,106,118,183,83,26,79,185,148,167,61,59,36,46,5,41,133,96,157,138,45,188,87,66,126,198,159,174,1,51,29,154,156,160,71,69,190,43,128,85,164,111,88,40,37,145,139,33,13,172,195,182,109,141,35,6,56,92,194,31,171,152,57,186,113,196,89,162,146,28,74,4,97,131,0,199,62,44,34,108,20,55,155,184,161,80,137,177,169,191,11,104,180,163,170,95,91,90,125,149,32,68,63,100,116,175,165,193,16,136,144,70,19,64,103,112,84,77,115,179,176,42,47,132,166,119,48];23;False
2509;7243;9752;[74,172,12,22,26,87,178,3,2,130,84,117,77,112,109,118,66,157,103,105,92,188,93,147,6,149,167,61,45,138,41,49,78,128,42,57,37,121,162,126,143,160,91,1,33,124,94,196,36,182,140,31,82,23,189,81,0,85,104,20,146,193,9,144,170,95,38,139,19,46,51,50,34,194,180,123,176,67,32,72,163,25,70,65,16,190,11,113,156,71,165,184,174,8,173,18,131,110,101,59,80,100,30,134,148,195,97,58,175,151,7,191,181,68,198,142,137,158,54,52,119,187,39,107,55,14,13,111,132,89,75,4,15,135,53,183,69,159,164,90,28,155,73,99,106,136,115,152,35,161,102,86,133,76,122,116,44,125,145,56,21,108,192,40,169,129,29,154,60,177,27,43,127,96,171,141,98,114,64,79,179,47,88,5,186,199,83,153,166,24,150,10,185,62,120,197,168,17,48,63];24;False
1928;8551;10479;[72,49,102,122,114,3,2,129,189,105,99,73,140,147,192,10,123,17,8,94,173,18,25,120,24,197,15,9,150,143,67,60,142,65,124,178,130,22,38,21,135,14,75,151,7,153,187,127,39,107,101,76,50,53,93,27,30,134,58,86,181,82,23,12,54,158,121,168,117,98,78,110,81,52,106,118,183,83,26,79,185,148,167,61,59,36,46,5,41,133,96,157,138,45,188,87,66,126,198,159,174,1,51,29,154,156,160,71,69,190,43,128,85,164,111,88,40,37,145,139,33,13,172,195,182,109,141,35,6,56,92,194,31,171,152,57,186,113,196,89,162,146,28,74,4,97,131,0,199,62,44,34,108,20,55,155,184,161,80,137,177,169,191,11,104,180,163,170,95,91,90,125,149,32,68,63,100,116,175,165,193,16,136,144,70,19,64,103,112,84,77,115,179,176,42,47,132,166,119,48];25;False
2501;7244;9745;[50,172,12,22,26,87,178,3,2,130,84,117,77,112,109,118,66,157,103,105,92,188,93,147,6,149,167,61,45,138,41,49,78,128,42,57,37,121,162,126,143,160,91,1,33,124,94,196,36,182,140,31,82,23,189,81,0,85,104,20,146,193,9,144,170,95,38,139,19,46,51,74,34,194,180,123,176,67,32,72,163,25,70,65,16,190,11,113,156,71,165,184,174,8,173,18,131,110,101,59,80,100,30,134,148,195,97,58,175,151,7,191,181,68,198,142,137,158,54,52,119,187,39,107,55,14,13,111,132,89,75,4,15,135,53,183,69,159,164,90,28,155,73,99,106,136,115,152,35,161,102,86,133,76,122,116,44,125,145,56,21,108,192,40,169,129,29,154,60,177,27,43,127,96,171,141,98,114,64,79,179,47,88,5,186,199,83,153,166,24,150,10,185,62,120,197,168,17,48,63];26;False
1776;8574;10350;[189,49,102,122,114,3,2,129,72,105,99,73,140,147,192,10,123,17,8,94,173,18,25,120,24,197,15,9,150,143,67,60,142,65,124,178,130,22,38,21,135,14,75,151,7,153,187,127,39,107,101,76,50,53,93,27,30,134,58,86,181,82,23,12,54,158,121,168,117,98,78,110,81,52,106,118,183,83,26,79,185,148,167,61,59,36,46,5,41,133,96,157,138,45,188,87,66,126,198,159,174,1,51,29,154,156,160,71,69,190,43,128,85,164,111,88,40,37,145,139,33,13,172,195,182,109,141,35,6,56,92,194,31,171,152,57,186,113,196,89,162,146,28,74,4,97,131,0,199,62,44,34,108,20,55,155,184,161,80,137,177,169,191,11,104,180,163,170,95,91,90,125,149,32,68,63,100,116,175,165,193,16,136,144,70,19,64,103,112,84,77,115,179,176,42,47,132,166,119,48];27;True
2423;7244;9667;[50,172,12,22,26,178,87,3,2,130,84,117,77,112,109,118,66,157,103,105,92,188,93,147,6,149,167,61,45,138,41,49,78,128,42,57,37,121,162,126,143,160,91,1,33,124,94,196,36,182,140,31,82,23,189,81,0,85,104,20,146,193,9,144,170,95,38,139,19,46,51,74,34,194,180,123,176,67,32,72,163,25,70,65,16,190,11,113,156,71,165,184,174,8,173,18,131,110,101,59,80,100,30,134,148,195,97,58,175,151,7,191,181,68,198,142,137,158,54,52,119,187,39,107,55,14,13,111,132,89,75,4,15,135,53,183,69,159,164,90,28,155,73,99,106,136,115,152,35,161,102,86,133,76,122,116,44,125,145,56,21,108,192,40,169,129,29,154,60,177,27,43,127,96,171,141,98,114,64,79,179,47,88,5,186,199,83,153,166,24,150,10,185,62,120,197,168,17,48,63];28;False
1911;8555;10466;[21,49,102,122,114,3,2,129,72,105,99,73,140,147,192,10,123,17,8,94,173,18,25,120,24,197,15,9,150,143,67,60,142,65,124,178,130,22,38,189,135,14,75,151,7,153,187,127,39,107,101,76,50,53,93,27,30,134,58,86,181,82,23,12,54,158,121,168,117,98,78,110,81,52,106,118,183,83,26,79,185,148,167,61,59,36,46,5,41,133,96,157,138,45,188,87,66,126,198,159,174,1,51,29,154,156,160,71,69,190,43,128,85,164,111,88,40,37,145,139,33,13,172,195,182,109,141,35,6,56,92,194,31,171,152,57,186,113,196,89,162,146,28,74,4,97,131,0,199,62,44,34,108,20,55,155,184,161,80,137,177,169,191,11,104,180,163,170,95,91,90,125,149,32,68,63,100,116,175,165,193,16,136,144,70,19,64,103,112,84,77,115,179,176,42,47,132,166,119,48];29;False
2431;7243;9674;[74,172,12,22,26,178,87,3,2,130,84,117,77,112,109,118,66,157,103,105,92,188,93,147,6,149,167,61,45,138,41,49,78,128,42,57,37,121,162,126,143,160,91,1,33,124,94,196,36,182,140,31,82,23,189,81,0,85,104,20,146,193,9,144,170,95,38,139,19,46,51,50,34,194,180,123,176,67,32,72,163,25,70,65,16,190,11,113,156,71,165,184,174,8,173,18,131,110,101,59,80,100,30,134,148,195,97,58,175,151,7,191,181,68,198,142,137,158,54,52,119,187,39,107,55,14,13,111,132,89,75,4,15,135,53,183,69,159,164,90,28,155,73,99,106,136,115,152,35,161,102,86,133,76,122,116,44,125,145,56,21,108,192,40,169,129,29,154,60,177,27,43,127,96,171,141,98,114,64,79,179,47,88,5,186,199,83,153,166,24,150,10,185,62,120,197,168,17,48,63];30;False
2036;8535;10571;[82,49,102,122,114,3,2,129,72,105,99,73,140,147,192,10,123,17,8,94,173,18,25,120,24,197,15,9,150,143,67,60,142,65,124,178,130,22,38,189,135,14,75,151,7,153,187,127,39,107,101,76,50,53,93,27,30,134,58,86,181,21,23,12,54,158,121,168,117,98,78,110,81,52,106,118,183,83,26,79,185,148,167,61,59,36,46,5,41,133,96,157,138,45,188,87,66,126,198,159,174,1,51,29,154,156,160,71,69,190,43,128,85,164,111,88,40,37,145,139,33,13,172,195,182,109,141,35,6,56,92,194,31,171,152,57,186,113,196,89,162,146,28,74,4,97,131,0,199,62,44,34,108,20,55,155,184,161,80,137,177,169,191,11,104,180,163,170,95,91,90,125,149,32,68,63,100,116,175,165,193,16,136,144,70,19,64,103,112,84,77,115,179,176,42,47,132,166,119,48];31;False
2438;7216;9654;[92,172,12,22,26,178,87,3,2,130,84,117,77,112,109,118,66,157,103,105,74,188,93,147,6,149,167,61,45,138,41,49,78,128,42,57,37,121,162,126,143,160,91,1,33,124,94,196,36,182,140,31,82,23,189,81,0,85,104,20,146,193,9,144,170,95,38,139,19,46,51,50,34,194,180,123,176,67,32,72,163,25,70,65,16,190,11,113,156,71,165,184,174,8,173,18,131,110,101,59,80,100,30,134,148,195,97,58,175,151,7,191,181,68,198,142,137,158,54,52,119,187,39,107,55,14,13,111,132,89,75,4,15,135,53,183,69,159,164,90,28,155,73,99,106,136,115,152,35,161,102,86,133,76,122,116,44,125,145,56,21,108,192,40,169,129,29,154,60,177,27,43,127,96,171,141,98,114,64,79,179,47,88,5,186,199,83,153,166,24,150,10,185,62,120,197,168,17,48,63];32;True
2070;8530;10600;[63,49,102,122,114,3,2,129,72,105,99,73,140,147,192,10,123,17,8,94,173,18,25,120,24,197,15,9,150,143,67,60,142,65,124,178,130,22,38,189,135,14,75,151,7,153,187,127,39,107,101,76,50,53,93,27,30,134,58,86,181,21,23,12,54,158,121,168,117,98,78,110,81,52,106,118,183,83,26,79,185,148,167,61,59,36,46,5,41,133,96,157,138,45,188,87,66,126,198,159,174,1,51,29,154,156,160,71,69,190,43,128,85,164,111,88,40,37,145,139,33,13,172,195,182,109,141,35,6,56,92,194,31,171,152,57,186,113,196,89,162,146,28,74,4,97,131,0,199,62,44,34,108,20,55,155,184,161,80,137,177,169,191,11,104,180,163,170,95,91,90,125,149,32,68,82,100,116,175,165,193,16,136,144,70,19,64,103,112,84,77,115,179,176,42,47,132,166,119,48];33;False
2394;7242;9636;[162,172,12,22,26,178,87,3,2,130,84,117,77,112,109,118,66,157,103,105,74,188,93,147,6,149,167,61,45,138,41,49,78,128,42,57,37,121,92,126,143,160,91,1,33,124,94,196,36,182,140,31,82,23,189,81,0,85,104,20,146,193,9,144,170,95,38,139,19,46,51,50,34,194,180,123,176,67,32,72,163,25,70,65,16,190,11,113,156,71,165,184,174,8,173,18,131,110,101,59,80,100,30,134,148,195,97,58,175,151,7,191,181,68,198,142,137,158,54,52,119,187,39,107,55,14,13,111,132,89,75,4,15,135,53,183,69,159,164,90,28,155,73,99,106,136,115,152,35,161,102,86,133,76,122,116,44,125,145,56,21,108,192,40,169,129,29,154,60,177,27,43,127,96,171,141,98,114,64,79,179,47,88,5,186,199,83,153,166,24,150,10,185,62,120,197,168,17,48,63];34;False
2085;8518;10603;[63,49,122,102,114,3,2,129,72,105,99,73,140,147,192,10,123,17,8,94,173,18,25,120,24,197,15,9,150,143,67,60,142,65,124,178,130,22,38,189,135,14,75,151,7,153,187,127,39,107,101,76,50,53,93,27,30,134,58,86,181,21,23,12,54,158,121,168,117,98,78,110,81,52,106,118,183,83,26,79,185,148,167,61,59,36,46,5,41,133,96,157,138,45,188,87,66,126,198,159,174,1,51,29,154,156,160,71,69,190,43,128,85,164,111,88,40,37,145,139,33,13,172,195,182,109,141,35,6,56,92,194,31,171,152,57,186,113,196,89,162,146,28,74,4,97,131,0,199,62,44,34,108,20,55,155,184,161,80,137,177,169,191,11,104,180,163,170,95,91,90,125,149,32,68,82,100,116,175,165,193,16,136,144,70,19,64,103,112,84,77,115,179,176,42,47,132,166,119,48];35;False
2367;7236;9603;[118,172,12,22,26,178,87,3,2,130,84,117,77,112,109,162,66,157,103,105,74,188,93,147,6,149,167,61,45,138,41,49,78,128,42,57,37,121,92,126,143,160,91,1,33,124,94,196,36,182,140,31,82,23,189,81,0,85,104,20,146,193,9,144,170,95,38,139,19,46,51,50,34,194,180,123,176,67,32,72,163,25,70,65,16,190,11,113,156,71,165,184,174,8,173,18,131,110,101,59,80,100,30,134,148,195,97,58,175,151,7,191,181,68,198,142,137,158,54,52,119,187,39,107,55,14,13,111,132,89,75,4,15,135,53,183,69,159,164,90,28,155,73,99,106,136,115,152,35,161,102,86,133,76,122,116,44,125,145,56,21,108,192,40,169,129,29,154,60,177,27,43,127,96,171,141,98,114,64,79,179,47,88,5,186,199,83,153,166,24,150,10,185,62,120,197,168,17,48,63];36;False
2051;8523;10574;[82,49,122,102,114,3,2,129,72,105,99,73,140,147,192,10,123,17,8,94,173,18,25,120,24,197,15,9,150,143,67,60,142,65,124,178,130,22,38,189,135,14,75,151,7,153,187,127,39,107,101,76,50,53,93,27,30,134,58,86,181,21,23,12,54,158,121,168,117,98,78,110,81,52,106,118,183,83,26,79,185,148,167,61,59,36,46,5,41,133,96,157,138,45,188,87,66,126,198,159,174,1,51,29,154,156,160,71,69,190,43,128,85,164,111,88,40,37,145,139,33,13,172,195,182,109,141,35,6,56,92,194,31,171,152,57,186,113,196,89,162,146,28,74,4,97,131,0,199,62,44,34,108,20,55,155,184,161,80,137,177,169,191,11,104,180,163,170,95,91,90,125,149,32,68,63,100,116,175,165,193,16,136,144,70,19,64,103,112,84,77,115,179,176,42,47,132,166,119,48];37;False
2431;7232;9663;[147,172,12,22,26,178,87,3,2,130,84,117,77,112,109,162,66,157,103,105,74,188,93,118,6,149,167,61,45,138,41,49,78,128,42,57,37,121,92,126,143,160,91,1,33,124,94,196,36,182,140,31,82,23,189,81,0,85,104,20,146,193,9,144,170,95,38,139,19,46,51,50,34,194,180,123,176,67,32,72,163,25,70,65,16,190,11,113,156,71,165,184,174,8,173,18,131,110,101,59,80,100,30,134,148,195,97,58,175,151,7,191,181,68,198,142,137,158,54,52,119,187,39,107,55,14,13,111,132,89,75,4,15,135,53,183,69,159,164,90,28,155,73,99,106,136,115,152,35,161,102,86,133,76,122,116,44,125,145,56,21,108,192,40,169,129,29,154,60,177,27,43,127,96,171,141,98,114,64,79,179,47,88,5,186,199,83,153,166,24,150,10,185,62,120,197,168,17,48,63];38;False
1926;8543;10469;[21,49,122,102,114,3,2,129,72,105,99,73,140,147,192,10,123,17,8,94,173,18,25,120,24,197,15,9,150,143,67,60,142,65,124,178,130,22,38,189,135,14,75,151,7,153,187,127,39,107,101,76,50,53,93,27,30,134,58,86,181,82,23,12,54,158,121,168,117,98,78,110,81,52,106,118,183,83,26,79,185,148,167,61,59,36,46,5,41,133,96,157,138,45,188,87,66,126,198,159,174,1,51,29,154,156,160,71,69,190,43,128,85,164,111,88,40,37,145,139,33,13,172,195,182,109,141,35,6,56,92,194,31,171,152,57,186,113,196,89,162,146,28,74,4,97,131,0,199,62,44,34,108,20,55,155,184,161,80,137,177,169,191,11,104,180,163,170,95,91,90,125,149,32,68,63,100,116,175,165,193,16,136,144,70,19,64,103,112,84,77,115,179,176,42,47,132,166,119,48];39;False
2309;7256;9565;[87,172,12,22,26,178,147,3,2,130,84,117,77,112,109,162,66,157,103,105,74,188,93,118,6,149,167,61,45,138,41,49,78,128,42,57,37,121,92,126,143,160,91,1,33,124,94,196,36,182,140,31,82,23,189,81,0,85,104,20,146,193,9,144,170,95,38,139,19,46,51,50,34,194,180,123,176,67,32,72,163,25,70,65,16,190,11,113,156,71,165,184,174,8,173,18,131,110,101,59,80,100,30,134,148,195,97,58,175,151,7,191,181,68,198,142,137,158,54,52,119,187,39,107,55,14,13,111,132,89,75,4,15,135,53,183,69,159,164,90,28,155,73,99,106,136,115,152,35,161,102,86,133,76,122,116,44,125,145,56,21,108,192,40,169,129,29,154,60,177,27,43,127,96,171,141,98,114,64,79,179,47,88,5,186,199,83,153,166,24,150,10,185,62,120,197,168,17,48,63];40;False
1980;8536;10516;[143,49,122,102,114,3,2,129,72,105,99,73,140,147,192,10,123,17,8,94,173,18,25,120,24,197,15,9,150,21,67,60,142,65,124,178,130,22,38,189,135,14,75,151,7,153,187,127,39,107,101,76,50,53,93,27,30,134,58,86,181,82,23,12,54,158,121,168,117,98,78,110,81,52,106,118,183,83,26,79,185,148,167,61,59,36,46,5,41,133,96,157,138,45,188,87,66,126,198,159,174,1,51,29,154,156,160,71,69,190,43,128,85,164,111,88,40,37,145,139,33,13,172,195,182,109,141,35,6,56,92,194,31,171,152,57,186,113,196,89,162,146,28,74,4,97,131,0,199,62,44,34,108,20,55,155,184,161,80,137,177,169,191,11,104,180,163,170,95,91,90,125,149,32,68,63,100,116,175,165,193,16,136,144,70,19,64,103,112,84,77,115,179,176,42,47,132,166,119,48];41;False
2355;7254;9609;[162,172,12,22,26,178,147,3,2,130,84,117,77,112,109,87,66,157,103,105,74,188,93,118,6,149,167,61,45,138,41,49,78,128,42,57,37,121,92,126,143,160,91,1,33,124,94,196,36,182,140,31,82,23,189,81,0,85,104,20,146,193,9,144,170,95,38,139,19,46,51,50,34,194,180,123,176,67,32,72,163,25,70,65,16,190,11,113,156,71,165,184,174,8,173,18,131,110,101,59,80,100,30,134,148,195,97,58,175,151,7,191,181,68,198,142,137,158,54,52,119,187,39,107,55,14,13,111,132,89,75,4,15,135,53,183,69,159,164,90,28,155,73,99,106,136,115,152,35,161,102,86,133,76,122,116,44,125,145,56,21,108,192,40,169,129,29,154,60,177,27,43,127,96,171,141,98,114,64,79,179,47,88,5,186,199,83,153,166,24,150,10,185,62,120,197,168,17,48,63];42;False
2005;8523;10528;[82,49,122,102,114,3,2,129,72,105,99,73,140,147,192,10,123,17,8,94,173,18,25,120,24,197,15,9,150,21,67,60,142,65,124,178,130,22,38,189,135,14,75,151,7,153,187,127,39,107,101,76,50,53,93,27,30,134,58,86,181,143,23,12,54,158,121,168,117,98,78,110,81,52,106,118,183,83,26,79,185,148,167,61,59,36,46,5,41,133,96,157,138,45,188,87,66,126,198,159,174,1,51,29,154,156,160,71,69,190,43,128,85,164,111,88,40,37,145,139,33,13,172,195,182,109,141,35,6,56,92,194,31,171,152,57,186,113,196,89,162,146,28,74,4,97,131,0,199,62,44,34,108,20,55,155,184,161,80,137,177,169,191,11,104,180,163,170,95,91,90,125,149,32,68,63,100,116,175,165,193,16,136,144,70,19,64,103,112,84,77,115,179,176,42,47,132,166,119,48];43;False
2399;7228;9627;[92,172,12,22,26,178,147,3,2,130,84,117,77,112,109,87,66,157,103,105,74,188,93,118,6,149,167,61,45,138,41,49,78,128,42,57,37,121,162,126,143,160,91,1,33,124,94,196,36,182,140,31,82,23,189,81,0,85,104,20,146,193,9,144,170,95,38,139,19,46,51,50,34,194,180,123,176,67,32,72,163,25,70,65,16,190,11,113,156,71,165,184,174,8,173,18,131,110,101,59,80,100,30,134,148,195,97,58,175,151,7,191,181,68,198,142,137,158,54,52,119,187,39,107,55,14,13,111,132,89,75,4,15,135,53,183,69,159,164,90,28,155,73,99,106,136,115,152,35,161,102,86,133,76,122,116,44,125,145,56,21,108,192,40,169,129,29,154,60,177,27,43,127,96,171,141,98,114,64,79,179,47,88,5,186,199,83,153,166,24,150,10,185,62,120,197,168,17,48,63];44;True
2081;8516;10597;[198,49,122,102,114,3,2,129,72,105,99,73,140,147,192,10,123,17,8,94,173,18,25,120,24,197,15,9,150,21,67,60,142,65,124,178,130,22,38,189,135,14,75,151,7,153,187,127,39,107,101,76,50,53,93,27,30,134,58,86,181,143,23,12,54,158,121,168,117,98,78,110,81,52,106,118,183,83,26,79,185,148,167,61,59,36,46,5,41,133,96,157,138,45,188,87,66,126,82,159,174,1,51,29,154,156,160,71,69,190,43,128,85,164,111,88,40,37,145,139,33,13,172,195,182,109,141,35,6,56,92,194,31,171,152,57,186,113,196,89,162,146,28,74,4,97,131,0,199,62,44,34,108,20,55,155,184,161,80,137,177,169,191,11,104,180,163,170,95,91,90,125,149,32,68,63,100,116,175,165,193,16,136,144,70,19,64,103,112,84,77,115,179,176,42,47,132,166,119,48];45;False
2365;7253;9618;[178,172,12,22,26,92,147,3,2,130,84,117,77,112,109,87,66,157,103,105,74,188,93,118,6,149,167,61,45,138,41,49,78,128,42,57,37,121,162,126,143,160,91,1,33,124,94,196,36,182,140,31,82,23,189,81,0,85,104,20,146,193,9,144,170,95,38,139,19,46,51,50,34,194,180,123,176,67,32,72,163,25,70,65,16,190,11,113,156,71,165,184,174,8,173,18,131,110,101,59,80,100,30,134,148,195,97,58,175,151,7,191,181,68,198,142,137,158,54,52,119,187,39,107,55,14,13,111,132,89,75,4,15,135,53,183,69,159,164,90,28,155,73,99,106,136,115,152,35,161,102,86,133,76,122,116,44,125,145,56,21,108,192,40,169,129,29,154,60,177,27,43,127,96,171,141,98,114,64,79,179,47,88,5,186,199,83,153,166,24,150,10,185,62,120,197,168,17,48,63];46;False
2064;8509;10573;[198,49,122,102,114,3,2,129,135,105,99,73,140,147,192,10,123,17,8,94,173,18,25,120,24,197,15,9,150,21,67,60,142,65,124,178,130,22,38,189,72,14,75,151,7,153,187,127,39,107,101,76,50,53,93,27,30,134,58,86,181,143,23,12,54,158,121,168,117,98,78,110,81,52,106,118,183,83,26,79,185,148,167,61,59,36,46,5,41,133,96,157,138,45,188,87,66,126,82,159,174,1,51,29,154,156,160,71,69,190,43,128,85,164,111,88,40,37,145,139,33,13,172,195,182,109,141,35,6,56,92,194,31,171,152,57,186,113,196,89,162,146,28,74,4,97,131,0,199,62,44,34,108,20,55,155,184,161,80,137,177,169,191,11,104,180,163,170,95,91,90,125,149,32,68,63,100,116,175,165,193,16,136,144,70,19,64,103,112,84,77,115,179,176,42,47,132,166,119,48];47;False
2274;7278;9552;[109,172,12,22,26,92,147,3,2,130,84,117,77,112,178,87,66,157,103,105,74,188,93,118,6,149,167,61,45,138,41,49,78,128,42,57,37,121,162,126,143,160,91,1,33,124,94,196,36,182,140,31,82,23,189,81,0,85,104,20,146,193,9,144,170,95,38,139,19,46,51,50,34,194,180,123,176,67,32,72,163,25,70,65,16,190,11,113,156,71,165,184,174,8,173,18,131,110,101,59,80,100,30,134,148,195,97,58,175,151,7,191,181,68,198,142,137,158,54,52,119,187,39,107,55,14,13,111,132,89,75,4,15,135,53,183,69,159,164,90,28,155,73,99,106,136,115,152,35,161,102,86,133,76,122,116,44,125,145,56,21,108,192,40,169,129,29,154,60,177,27,43,127,96,171,141,98,114,64,79,179,47,88,5,186,199,83,153,166,24,150,10,185,62,120,197,168,17,48,63];48;False
1988;8516;10504;[82,49,122,102,114,3,2,129,135,105,99,73,140,147,192,10,123,17,8,94,173,18,25,120,24,197,15,9,150,21,67,60,142,65,124,178,130,22,38,189,72,14,75,151,7,153,187,127,39,107,101,76,50,53,93,27,30,134,58,86,181,143,23,12,54,158,121,168,117,98,78,110,81,52,106,118,183,83,26,79,185,148,167,61,59,36,46,5,41,133,96,157,138,45,188,87,66,126,198,159,174,1,51,29,154,156,160,71,69,190,43,128,85,164,111,88,40,37,145,139,33,13,172,195,182,109,141,35,6,56,92,194,31,171,152,57,186,113,196,89,162,146,28,74,4,97,131,0,199,62,44,34,108,20,55,155,184,161,80,137,177,169,191,11,104,180,163,170,95,91,90,125,149,32,68,63,100,116,175,165,193,16,136,144,70,19,64,103,112,84,77,115,179,176,42,47,132,166,119,48];49;False
2304;7274;9578;[87,172,12,22,26,92,147,3,2,130,84,117,77,112,178,109,66,157,103,105,74,188,93,118,6,149,167,61,45,138,41,49,78,128,42,57,37,121,162,126,143,160,91,1,33,124,94,196,36,182,140,31,82,23,189,81,0,85,104,20,146,193,9,144,170,95,38,139,19,46,51,50,34,194,180,123,176,67,32,72,163,25,70,65,16,190,11,113,156,71,165,184,174,8,173,18,131,110,101,59,80,100,30,134,148,195,97,58,175,151,7,191,181,68,198,142,137,158,54,52,119,187,39,107,55,14,13,111,132,89,75,4,15,135,53,183,69,159,164,90,28,155,73,99,106,136,115,152,35,161,102,86,133,76,122,116,44,125,145,56,21,108,192,40,169,129,29,154,60,177,27,43,127,96,171,141,98,114,64,79,179,47,88,5,186,199,83,153,166,24,150,10,185,62,120,197,168,17,48,63];50;False
1963;8529;10492;[143,49,122,102,114,3,2,129,135,105,99,73,140,147,192,10,123,17,8,94,173,18,25,120,24,197,15,9,150,21,67,60,142,65,124,178,130,22,38,189,72,14,75,151,7,153,187,127,39,107,101,76,50,53,93,27,30,134,58,86,181,82,23,12,54,158,121,168,117,98,78,110,81,52,106,118,183,83,26,79,185,148,167,61,59,36,46,5,41,133,96,157,138,45,188,87,66,126,198,159,174,1,51,29,154,156,160,71,69,190,43,128,85,164,111,88,40,37,145,139,33,13,172,195,182,109,141,35,6,56,92,194,31,171,152,57,186,113,196,89,162,146,28,74,4,97,131,0,199,62,44,34,108,20,55,155,184,161,80,137,177,169,191,11,104,180,163,170,95,91,90,125,149,32,68,63,100,116,175,165,193,16,136,144,70,19,64,103,112,84,77,115,179,176,42,47,132,166,119,48];51;False
2321;7255;9576;[178,172,12,22,26,92,147,3,2,130,84,117,77,112,87,109,66,157,103,105,74,188,93,118,6,149,167,61,45,138,41,49,78,128,42,57,37,121,162,126,143,160,91,1,33,124,94,196,36,182,140,31,82,23,189,81,0,85,104,20,146,193,9,144,170,95,38,139,19,46,51,50,34,194,180,123,176,67,32,72,163,25,70,65,16,190,11,113,156,71,165,184,174,8,173,18,131,110,101,59,80,100,30,134,148,195,97,58,175,151,7,191,181,68,198,142,137,158,54,52,119,187,39,107,55,14,13,111,132,89,75,4,15,135,53,183,69,159,164,90,28,155,73,99,106,136,115,152,35,161,102,86,133,76,122,116,44,125,145,56,21,108,192,40,169,129,29,154,60,177,27,43,127,96,171,141,98,114,64,79,179,47,88,5,186,199,83,153,166,24,150,10,185,62,120,197,168,17,48,63];52;False
1909;8536;10445;[21,49,122,102,114,3,2,129,135,105,99,73,140,147,192,10,123,17,8,94,173,18,25,120,24,197,15,9,150,143,67,60,142,65,124,178,130,22,38,189,72,14,75,151,7,153,187,127,39,107,101,76,50,53,93,27,30,134,58,86,181,82,23,12,54,158,121,168,117,98,78,110,81,52,106,118,183,83,26,79,185,148,167,61,59,36,46,5,41,133,96,157,138,45,188,87,66,126,198,159,174,1,51,29,154,156,160,71,69,190,43,128,85,164,111,88,40,37,145,139,33,13,172,195,182,109,141,35,6,56,92,194,31,171,152,57,186,113,196,89,162,146,28,74,4,97,131,0,199,62,44,34,108,20,55,155,184,161,80,137,177,169,191,11,104,180,163,170,95,91,90,125,149,32,68,63,100,116,175,165,193,16,136,144,70,19,64,103,112,84,77,115,179,176,42,47,132,166,119,48];53;False
2355;7230;9585;[92,172,12,22,26,178,147,3,2,130,84,117,77,112,87,109,66,157,103,105,74,188,93,118,6,149,167,61,45,138,41,49,78,128,42,57,37,121,162,126,143,160,91,1,33,124,94,196,36,182,140,31,82,23,189,81,0,85,104,20,146,193,9,144,170,95,38,139,19,46,51,50,34,194,180,123,176,67,32,72,163,25,70,65,16,190,11,113,156,71,165,184,174,8,173,18,131,110,101,59,80,100,30,134,148,195,97,58,175,151,7,191,181,68,198,142,137,158,54,52,119,187,39,107,55,14,13,111,132,89,75,4,15,135,53,183,69,159,164,90,28,155,73,99,106,136,115,152,35,161,102,86,133,76,122,116,44,125,145,56,21,108,192,40,169,129,29,154,60,177,27,43,127,96,171,141,98,114,64,79,179,47,88,5,186,199,83,153,166,24,150,10,185,62,120,197,168,17,48,63];54;True
1903;8552;10455;[142,49,122,102,114,3,2,129,135,105,99,73,140,147,192,10,123,17,8,94,173,18,25,120,24,197,15,9,150,143,67,60,21,65,124,178,130,22,38,189,72,14,75,151,7,153,187,127,39,107,101,76,50,53,93,27,30,134,58,86,181,82,23,12,54,158,121,168,117,98,78,110,81,52,106,118,183,83,26,79,185,148,167,61,59,36,46,5,41,133,96,157,138,45,188,87,66,126,198,159,174,1,51,29,154,156,160,71,69,190,43,128,85,164,111,88,40,37,145,139,33,13,172,195,182,109,141,35,6,56,92,194,31,171,152,57,186,113,196,89,162,146,28,74,4,97,131,0,199,62,44,34,108,20,55,155,184,161,80,137,177,169,191,11,104,180,163,170,95,91,90,125,149,32,68,63,100,116,175,165,193,16,136,144,70,19,64,103,112,84,77,115,179,176,42,47,132,166,119,48];55;False
2285;7261;9546;[140,172,12,22,26,178,147,3,2,130,84,117,77,112,87,109,66,157,103,105,74,188,93,118,6,149,167,61,45,138,41,49,78,128,42,57,37,121,162,126,143,160,91,1,33,124,94,196,36,182,92,31,82,23,189,81,0,85,104,20,146,193,9,144,170,95,38,139,19,46,51,50,34,194,180,123,176,67,32,72,163,25,70,65,16,190,11,113,156,71,165,184,174,8,173,18,131,110,101,59,80,100,30,134,148,195,97,58,175,151,7,191,181,68,198,142,137,158,54,52,119,187,39,107,55,14,13,111,132,89,75,4,15,135,53,183,69,159,164,90,28,155,73,99,106,136,115,152,35,161,102,86,133,76,122,116,44,125,145,56,21,108,192,40,169,129,29,154,60,177,27,43,127,96,171,141,98,114,64,79,179,47,88,5,186,199,83,153,166,24,150,10,185,62,120,197,168,17,48,63];56;False
1902;8535;10437;[146,49,122,102,114,3,2,129,135,105,99,73,140,147,192,10,123,17,8,94,173,18,25,120,24,197,15,9,150,143,67,60,21,65,124,178,130,22,38,189,72,14,75,151,7,153,187,127,39,107,101,76,50,53,93,27,30,134,58,86,181,82,23,12,54,158,121,168,117,98,78,110,81,52,106,118,183,83,26,79,185,148,167,61,59,36,46,5,41,133,96,157,138,45,188,87,66,126,198,159,174,1,51,29,154,156,160,71,69,190,43,128,85,164,111,88,40,37,145,139,33,13,172,195,182,109,141,35,6,56,92,194,31,171,152,57,186,113,196,89,162,142,28,74,4,97,131,0,199,62,44,34,108,20,55,155,184,161,80,137,177,169,191,11,104,180,163,170,95,91,90,125,149,32,68,63,100,116,175,165,193,16,136,144,70,19,64,103,112,84,77,115,179,176,42,47,132,166,119,48];57;False
2279;7274;9553;[178,172,12,22,26,140,147,3,2,130,84,117,77,112,87,109,66,157,103,105,74,188,93,118,6,149,167,61,45,138,41,49,78,128,42,57,37,121,162,126,143,160,91,1,33,124,94,196,36,182,92,31,82,23,189,81,0,85,104,20,146,193,9,144,170,95,38,139,19,46,51,50,34,194,180,123,176,67,32,72,163,25,70,65,16,190,11,113,156,71,165,184,174,8,173,18,131,110,101,59,80,100,30,134,148,195,97,58,175,151,7,191,181,68,198,142,137,158,54,52,119,187,39,107,55,14,13,111,132,89,75,4,15,135,53,183,69,159,164,90,28,155,73,99,106,136,115,152,35,161,102,86,133,76,122,116,44,125,145,56,21,108,192,40,169,129,29,154,60,177,27,43,127,96,171,141,98,114,64,79,179,47,88,5,186,199,83,153,166,24,150,10,185,62,120,197,168,17,48,63];58;False
1950;8530;10480;[106,49,122,102,114,3,2,129,135,105,99,73,140,147,192,10,123,17,8,94,173,18,25,120,24,197,15,9,150,143,67,60,21,65,124,178,130,22,38,189,72,14,75,151,7,153,187,127,39,107,101,76,50,53,93,27,30,134,58,86,181,82,23,12,54,158,121,168,117,98,78,110,81,52,146,118,183,83,26,79,185,148,167,61,59,36,46,5,41,133,96,157,138,45,188,87,66,126,198,159,174,1,51,29,154,156,160,71,69,190,43,128,85,164,111,88,40,37,145,139,33,13,172,195,182,109,141,35,6,56,92,194,31,171,152,57,186,113,196,89,162,142,28,74,4,97,131,0,199,62,44,34,108,20,55,155,184,161,80,137,177,169,191,11,104,180,163,170,95,91,90,125,149,32,68,63,100,116,175,165,193,16,136,144,70,19,64,103,112,84,77,115,179,176,42,47,132,166,119,48];59;False
2273;7277;9550;[31,172,12,22,26,140,147,3,2,130,84,117,77,112,87,109,66,157,103,105,74,188,93,118,6,149,167,61,45,138,41,49,78,128,42,57,37,121,162,126,143,160,91,1,33,124,94,196,36,182,92,178,82,23,189,81,0,85,104,20,146,193,9,144,170,95,38,139,19,46,51,50,34,194,180,123,176,67,32,72,163,25,70,65,16,190,11,113,156,71,165,184,174,8,173,18,131,110,101,59,80,100,30,134,148,195,97,58,175,151,7,191,181,68,198,142,137,158,54,52,119,187,39,107,55,14,13,111,132,89,75,4,15,135,53,183,69,159,164,90,28,155,73,99,106,136,115,152,35,161,102,86,133,76,122,116,44,125,145,56,21,108,192,40,169,129,29,154,60,177,27,43,127,96,171,141,98,114,64,79,179,47,88,5,186,199,83,153,166,24,150,10,185,62,120,197,168,17,48,63];60;False
1975;8526;10501;[198,49,122,102,114,3,2,129,135,105,99,73,140,147,192,10,123,17,8,94,173,18,25,120,24,197,15,9,150,143,67,60,21,65,124,178,130,22,38,189,72,14,75,151,7,153,187,127,39,107,101,76,50,53,93,27,30,134,58,86,181,82,23,12,54,158,121,168,117,98,78,110,81,52,146,118,183,83,26,79,185,148,167,61,59,36,46,5,41,133,96,157,138,45,188,87,66,126,106,159,174,1,51,29,154,156,160,71,69,190,43,128,85,164,111,88,40,37,145,139,33,13,172,195,182,109,141,35,6,56,92,194,31,171,152,57,186,113,196,89,162,142,28,74,4,97,131,0,199,62,44,34,108,20,55,155,184,161,80,137,177,169,191,11,104,180,163,170,95,91,90,125,149,32,68,63,100,116,175,165,193,16,136,144,70,19,64,103,112,84,77,115,179,176,42,47,132,166,119,48];61;False
2209;7292;9501;[118,172,12,22,26,140,147,3,2,130,84,117,77,112,87,109,66,157,103,105,74,188,93,31,6,149,167,61,45,138,41,49,78,128,42,57,37,121,162,126,143,160,91,1,33,124,94,196,36,182,92,178,82,23,189,81,0,85,104,20,146,193,9,144,170,95,38,139,19,46,51,50,34,194,180,123,176,67,32,72,163,25,70,65,16,190,11,113,156,71,165,184,174,8,173,18,131,110,101,59,80,100,30,134,148,195,97,58,175,151,7,191,181,68,198,142,137,158,54,52,119,187,39,107,55,14,13,111,132,89,75,4,15,135,53,183,69,159,164,90,28,155,73,99,106,136,115,152,35,161,102,86,133,76,122,116,44,125,145,56,21,108,192,40,169,129,29,154,60,177,27,43,127,96,171,141,98,114,64,79,179,47,88,5,186,199,83,153,166,24,150,10,185,62,120,197,168,17,48,63];62;True
2037;8502;10539;[154,49,122,102,114,3,2,129,135,105,99,73,140,147,192,10,123,17,8,94,173,18,25,120,24,197,15,9,150,143,67,60,21,65,124,178,130,22,38,189,72,14,75,151,7,153,187,127,39,107,101,76,50,53,93,27,30,134,58,86,181,82,23,12,54,158,121,168,117,98,78,110,81,52,146,118,183,83,26,79,185,148,167,61,59,36,46,5,41,133,96,157,138,45,188,87,66,126,106,159,174,1,51,29,198,156,160,71,69,190,43,128,85,164,111,88,40,37,145,139,33,13,172,195,182,109,141,35,6,56,92,194,31,171,152,57,186,113,196,89,162,142,28,74,4,97,131,0,199,62,44,34,108,20,55,155,184,161,80,137,177,169,191,11,104,180,163,170,95,91,90,125,149,32,68,63,100,116,175,165,193,16,136,144,70,19,64,103,112,84,77,115,179,176,42,47,132,166,119,48];63;False
2264;7290;9554;[140,172,12,22,26,118,147,3,2,130,84,117,77,112,87,109,66,157,103,105,74,188,93,31,6,149,167,61,45,138,41,49,78,128,42,57,37,121,162,126,143,160,91,1,33,124,94,196,36,182,92,178,82,23,189,81,0,85,104,20,146,193,9,144,170,95,38,139,19,46,51,50,34,194,180,123,176,67,32,72,163,25,70,65,16,190,11,113,156,71,165,184,174,8,173,18,131,110,101,59,80,100,30,134,148,195,97,58,175,151,7,191,181,68,198,142,137,158,54,52,119,187,39,107,55,14,13,111,132,89,75,4,15,135,53,183,69,159,164,90,28,155,73,99,106,136,115,152,35,161,102,86,133,76,122,116,44,125,145,56,21,108,192,40,169,129,29,154,60,177,27,43,127,96,171,141,98,114,64,79,179,47,88,5,186,199,83,153,166,24,150,10,185,62,120,197,168,17,48,63];64;False
2007;8509;10516;[14,49,122,102,114,3,2,129,135,105,99,73,140,147,192,10,123,17,8,94,173,18,25,120,24,197,15,9,150,143,67,60,21,65,124,178,130,22,38,189,72,154,75,151,7,153,187,127,39,107,101,76,50,53,93,27,30,134,58,86,181,82,23,12,54,158,121,168,117,98,78,110,81,52,146,118,183,83,26,79,185,148,167,61,59,36,46,5,41,133,96,157,138,45,188,87,66,126,106,159,174,1,51,29,198,156,160,71,69,190,43,128,85,164,111,88,40,37,145,139,33,13,172,195,182,109,141,35,6,56,92,194,31,171,152,57,186,113,196,89,162,142,28,74,4,97,131,0,199,62,44,34,108,20,55,155,184,161,80,137,177,169,191,11,104,180,163,170,95,91,90,125,149,32,68,63,100,116,175,165,193,16,136,144,70,19,64,103,112,84,77,115,179,176,42,47,132,166,119,48];65;False
2268;7281;9549;[193,172,12,22,26,118,147,3,2,130,84,117,77,112,87,109,66,157,103,105,74,188,93,31,6,149,167,61,45,138,41,49,78,128,42,57,37,121,162,126,143,160,91,1,33,124,94,196,36,182,92,178,82,23,189,81,0,85,104,20,146,140,9,144,170,95,38,139,19,46,51,50,34,194,180,123,176,67,32,72,163,25,70,65,16,190,11,113,156,71,165,184,174,8,173,18,131,110,101,59,80,100,30,134,148,195,97,58,175,151,7,191,181,68,198,142,137,158,54,52,119,187,39,107,55,14,13,111,132,89,75,4,15,135,53,183,69,159,164,90,28,155,73,99,106,136,115,152,35,161,102,86,133,76,122,116,44,125,145,56,21,108,192,40,169,129,29,154,60,177,27,43,127,96,171,141,98,114,64,79,179,47,88,5,186,199,83,153,166,24,150,10,185,62,120,197,168,17,48,63];66;False
2030;8504;10534;[189,49,122,102,114,3,2,129,135,105,99,73,140,147,192,10,123,17,8,94,173,18,25,120,24,197,15,9,150,143,67,60,21,65,124,178,130,22,38,14,72,154,75,151,7,153,187,127,39,107,101,76,50,53,93,27,30,134,58,86,181,82,23,12,54,158,121,168,117,98,78,110,81,52,146,118,183,83,26,79,185,148,167,61,59,36,46,5,41,133,96,157,138,45,188,87,66,126,106,159,174,1,51,29,198,156,160,71,69,190,43,128,85,164,111,88,40,37,145,139,33,13,172,195,182,109,141,35,6,56,92,194,31,171,152,57,186,113,196,89,162,142,28,74,4,97,131,0,199,62,44,34,108,20,55,155,184,161,80,137,177,169,191,11,104,180,163,170,95,91,90,125,149,32,68,63,100,116,175,165,193,16,136,144,70,19,64,103,112,84,77,115,179,176,42,47,132,166,119,48];67;False
2264;7265;9529;[87,172,12,22,26,118,147,3,2,130,84,117,77,112,193,109,66,157,103,105,74,188,93,31,6,149,167,61,45,138,41,49,78,128,42,57,37,121,162,126,143,160,91,1,33,124,94,196,36,182,92,178,82,23,189,81,0,85,104,20,146,140,9,144,170,95,38,139,19,46,51,50,34,194,180,123,176,67,32,72,163,25,70,65,16,190,11,113,156,71,165,184,174,8,173,18,131,110,101,59,80,100,30,134,148,195,97,58,175,151,7,191,181,68,198,142,137,158,54,52,119,187,39,107,55,14,13,111,132,89,75,4,15,135,53,183,69,159,164,90,28,155,73,99,106,136,115,152,35,161,102,86,133,76,122,116,44,125,145,56,21,108,192,40,169,129,29,154,60,177,27,43,127,96,171,141,98,114,64,79,179,47,88,5,186,199,83,153,166,24,150,10,185,62,120,197,168,17,48,63];68;True
2059;8487;10546;[60,49,122,102,114,3,2,129,135,105,99,73,140,147,192,10,123,17,8,94,173,18,25,120,24,197,15,9,150,143,67,189,21,65,124,178,130,22,38,14,72,154,75,151,7,153,187,127,39,107,101,76,50,53,93,27,30,134,58,86,181,82,23,12,54,158,121,168,117,98,78,110,81,52,146,118,183,83,26,79,185,148,167,61,59,36,46,5,41,133,96,157,138,45,188,87,66,126,106,159,174,1,51,29,198,156,160,71,69,190,43,128,85,164,111,88,40,37,145,139,33,13,172,195,182,109,141,35,6,56,92,194,31,171,152,57,186,113,196,89,162,142,28,74,4,97,131,0,199,62,44,34,108,20,55,155,184,161,80,137,177,169,191,11,104,180,163,170,95,91,90,125,149,32,68,63,100,116,175,165,193,16,136,144,70,19,64,103,112,84,77,115,179,176,42,47,132,166,119,48];69;False
2344;7241;9585;[118,172,12,22,26,87,147,3,2,130,84,117,77,112,193,109,66,157,103,105,74,188,93,31,6,149,167,61,45,138,41,49,78,128,42,57,37,121,162,126,143,160,91,1,33,124,94,196,36,182,92,178,82,23,189,81,0,85,104,20,146,140,9,144,170,95,38,139,19,46,51,50,34,194,180,123,176,67,32,72,163,25,70,65,16,190,11,113,156,71,165,184,174,8,173,18,131,110,101,59,80,100,30,134,148,195,97,58,175,151,7,191,181,68,198,142,137,158,54,52,119,187,39,107,55,14,13,111,132,89,75,4,15,135,53,183,69,159,164,90,28,155,73,99,106,136,115,152,35,161,102,86,133,76,122,116,44,125,145,56,21,108,192,40,169,129,29,154,60,177,27,43,127,96,171,141,98,114,64,79,179,47,88,5,186,199,83,153,166,24,150,10,185,62,120,197,168,17,48,63];70;False
2067;8482;10549;[3,49,122,102,114,60,2,129,135,105,99,73,140,147,192,10,123,17,8,94,173,18,25,120,24,197,15,9,150,143,67,189,21,65,124,178,130,22,38,14,72,154,75,151,7,153,187,127,39,107,101,76,50,53,93,27,30,134,58,86,181,82,23,12,54,158,121,168,117,98,78,110,81,52,146,118,183,83,26,79,185,148,167,61,59,36,46,5,41,133,96,157,138,45,188,87,66,126,106,159,174,1,51,29,198,156,160,71,69,190,43,128,85,164,111,88,40,37,145,139,33,13,172,195,182,109,141,35,6,56,92,194,31,171,152,57,186,113,196,89,162,142,28,74,4,97,131,0,199,62,44,34,108,20,55,155,184,161,80,137,177,169,191,11,104,180,163,170,95,91,90,125,149,32,68,63,100,116,175,165,193,16,136,144,70,19,64,103,112,84,77,115,179,176,42,47,132,166,119,48];71;False
2408;7226;9634;[31,172,12,22,26,87,147,3,2,130,84,117,77,112,193,109,66,157,103,105,74,188,93,118,6,149,167,61,45,138,41,49,78,128,42,57,37,121,162,126,143,160,91,1,33,124,94,196,36,182,92,178,82,23,189,81,0,85,104,20,146,140,9,144,170,95,38,139,19,46,51,50,34,194,180,123,176,67,32,72,163,25,70,65,16,190,11,113,156,71,165,184,174,8,173,18,131,110,101,59,80,100,30,134,148,195,97,58,175,151,7,191,181,68,198,142,137,158,54,52,119,187,39,107,55,14,13,111,132,89,75,4,15,135,53,183,69,159,164,90,28,155,73,99,106,136,115,152,35,161,102,86,133,76,122,116,44,125,145,56,21,108,192,40,169,129,29,154,60,177,27,43,127,96,171,141,98,114,64,79,179,47,88,5,186,199,83,153,166,24,150,10,185,62,120,197,168,17,48,63];72;False
2058;8483;10541;[117,49,122,102,114,60,2,129,135,105,99,73,140,147,192,10,123,17,8,94,173,18,25,120,24,197,15,9,150,143,67,189,21,65,124,178,130,22,38,14,72,154,75,151,7,153,187,127,39,107,101,76,50,53,93,27,30,134,58,86,181,82,23,12,54,158,121,168,3,98,78,110,81,52,146,118,183,83,26,79,185,148,167,61,59,36,46,5,41,133,96,157,138,45,188,87,66,126,106,159,174,1,51,29,198,156,160,71,69,190,43,128,85,164,111,88,40,37,145,139,33,13,172,195,182,109,141,35,6,56,92,194,31,171,152,57,186,113,196,89,162,142,28,74,4,97,131,0,199,62,44,34,108,20,55,155,184,161,80,137,177,169,191,11,104,180,163,170,95,91,90,125,149,32,68,63,100,116,175,165,193,16,136,144,70,19,64,103,112,84,77,115,179,176,42,47,132,166,119,48];73;False
2285;7256;9541;[87,172,12,22,26,31,147,3,2,130,84,117,77,112,193,109,66,157,103,105,74,188,93,118,6,149,167,61,45,138,41,49,78,128,42,57,37,121,162,126,143,160,91,1,33,124,94,196,36,182,92,178,82,23,189,81,0,85,104,20,146,140,9,144,170,95,38,139,19,46,51,50,34,194,180,123,176,67,32,72,163,25,70,65,16,190,11,113,156,71,165,184,174,8,173,18,131,110,101,59,80,100,30,134,148,195,97,58,175,151,7,191,181,68,198,142,137,158,54,52,119,187,39,107,55,14,13,111,132,89,75,4,15,135,53,183,69,159,164,90,28,155,73,99,106,136,115,152,35,161,102,86,133,76,122,116,44,125,145,56,21,108,192,40,169,129,29,154,60,177,27,43,127,96,171,141,98,114,64,79,179,47,88,5,186,199,83,153,166,24,150,10,185,62,120,197,168,17,48,63];74;True
2064;8450;10514;[21,49,122,102,114,60,2,129,135,105,99,73,140,147,192,10,123,17,8,94,173,18,25,120,24,197,15,9,150,143,67,189,117,65,124,178,130,22,38,14,72,154,75,151,7,153,187,127,39,107,101,76,50,53,93,27,30,134,58,86,181,82,23,12,54,158,121,168,3,98,78,110,81,52,146,118,183,83,26,79,185,148,167,61,59,36,46,5,41,133,96,157,138,45,188,87,66,126,106,159,174,1,51,29,198,156,160,71,69,190,43,128,85,164,111,88,40,37,145,139,33,13,172,195,182,109,141,35,6,56,92,194,31,171,152,57,186,113,196,89,162,142,28,74,4,97,131,0,199,62,44,34,108,20,55,155,184,161,80,137,177,169,191,11,104,180,163,170,95,91,90,125,149,32,68,63,100,116,175,165,193,16,136,144,70,19,64,103,112,84,77,115,179,176,42,47,132,166,119,48];75;False
2309;7240;9549;[118,172,12,22,26,31,147,3,2,130,84,117,77,112,193,109,66,157,103,105,74,188,93,87,6,149,167,61,45,138,41,49,78,128,42,57,37,121,162,126,143,160,91,1,33,124,94,196,36,182,92,178,82,23,189,81,0,85,104,20,146,140,9,144,170,95,38,139,19,46,51,50,34,194,180,123,176,67,32,72,163,25,70,65,16,190,11,113,156,71,165,184,174,8,173,18,131,110,101,59,80,100,30,134,148,195,97,58,175,151,7,191,181,68,198,142,137,158,54,52,119,187,39,107,55,14,13,111,132,89,75,4,15,135,53,183,69,159,164,90,28,155,73,99,106,136,115,152,35,161,102,86,133,76,122,116,44,125,145,56,21,108,192,40,169,129,29,154,60,177,27,43,127,96,171,141,98,114,64,79,179,47,88,5,186,199,83,153,166,24,150,10,185,62,120,197,168,17,48,63];76;True
1961;8476;10437;[14,49,122,102,114,60,2,129,135,105,99,73,140,147,192,10,123,17,8,94,173,18,25,120,24,197,15,9,150,143,67,189,117,65,124,178,130,22,38,21,72,154,75,151,7,153,187,127,39,107,101,76,50,53,93,27,30,134,58,86,181,82,23,12,54,158,121,168,3,98,78,110,81,52,146,118,183,83,26,79,185,148,167,61,59,36,46,5,41,133,96,157,138,45,188,87,66,126,106,159,174,1,51,29,198,156,160,71,69,190,43,128,85,164,111,88,40,37,145,139,33,13,172,195,182,109,141,35,6,56,92,194,31,171,152,57,186,113,196,89,162,142,28,74,4,97,131,0,199,62,44,34,108,20,55,155,184,161,80,137,177,169,191,11,104,180,163,170,95,91,90,125,149,32,68,63,100,116,175,165,193,16,136,144,70,19,64,103,112,84,77,115,179,176,42,47,132,166,119,48];77;False
2352;7234;9586;[31,172,12,22,26,118,147,3,2,130,84,117,77,112,193,109,66,157,103,105,74,188,93,87,6,149,167,61,45,138,41,49,78,128,42,57,37,121,162,126,143,160,91,1,33,124,94,196,36,182,92,178,82,23,189,81,0,85,104,20,146,140,9,144,170,95,38,139,19,46,51,50,34,194,180,123,176,67,32,72,163,25,70,65,16,190,11,113,156,71,165,184,174,8,173,18,131,110,101,59,80,100,30,134,148,195,97,58,175,151,7,191,181,68,198,142,137,158,54,52,119,187,39,107,55,14,13,111,132,89,75,4,15,135,53,183,69,159,164,90,28,155,73,99,106,136,115,152,35,161,102,86,133,76,122,116,44,125,145,56,21,108,192,40,169,129,29,154,60,177,27,43,127,96,171,141,98,114,64,79,179,47,88,5,186,199,83,153,166,24,150,10,185,62,120,197,168,17,48,63];78;True
1995;8473;10468;[147,49,122,102,114,60,2,129,135,105,99,73,140,14,192,10,123,17,8,94,173,18,25,120,24,197,15,9,150,143,67,189,117,65,124,178,130,22,38,21,72,154,75,151,7,153,187,127,39,107,101,76,50,53,93,27,30,134,58,86,181,82,23,12,54,158,121,168,3,98,78,110,81,52,146,118,183,83,26,79,185,148,167,61,59,36,46,5,41,133,96,157,138,45,188,87,66,126,106,159,174,1,51,29,198,156,160,71,69,190,43,128,85,164,111,88,40,37,145,139,33,13,172,195,182,109,141,35,6,56,92,194,31,171,152,57,186,113,196,89,162,142,28,74,4,97,131,0,199,62,44,34,108,20,55,155,184,161,80,137,177,169,191,11,104,180,163,170,95,91,90,125,149,32,68,63,100,116,175,165,193,16,136,144,70,19,64,103,112,84,77,115,179,176,42,47,132,166,119,48];79;False
2403;7222;9625;[20,172,12,22,26,118,147,3,2,130,84,117,77,112,193,109,66,157,103,105,74,188,93,87,6,149,167,61,45,138,41,49,78,128,42,57,37,121,162,126,143,160,91,1,33,124,94,196,36,182,92,178,82,23,189,81,0,85,104,31,146,140,9,144,170,95,38,139,19,46,51,50,34,194,180,123,176,67,32,72,163,25,70,65,16,190,11,113,156,71,165,184,174,8,173,18,131,110,101,59,80,100,30,134,148,195,97,58,175,151,7,191,181,68,198,142,137,158,54,52,119,187,39,107,55,14,13,111,132,89,75,4,15,135,53,183,69,159,164,90,28,155,73,99,106,136,115,152,35,161,102,86,133,76,122,116,44,125,145,56,21,108,192,40,169,129,29,154,60,177,27,43,127,96,171,141,98,114,64,79,179,47,88,5,186,199,83,153,166,24,150,10,185,62,120,197,168,17,48,63];80;True
1952;8510;10462;[150,49,122,102,114,60,2,129,135,105,99,73,140,14,192,10,123,17,8,94,173,18,25,120,24,197,15,9,147,143,67,189,117,65,124,178,130,22,38,21,72,154,75,151,7,153,187,127,39,107,101,76,50,53,93,27,30,134,58,86,181,82,23,12,54,158,121,168,3,98,78,110,81,52,146,118,183,83,26,79,185,148,167,61,59,36,46,5,41,133,96,157,138,45,188,87,66,126,106,159,174,1,51,29,198,156,160,71,69,190,43,128,85,164,111,88,40,37,145,139,33,13,172,195,182,109,141,35,6,56,92,194,31,171,152,57,186,113,196,89,162,142,28,74,4,97,131,0,199,62,44,34,108,20,55,155,184,161,80,137,177,169,191,11,104,180,163,170,95,91,90,125,149,32,68,63,100,116,175,165,193,16,136,144,70,19,64,103,112,84,77,115,179,176,42,47,132,166,119,48];81;False
2493;7207;9700;[82,172,12,22,26,118,147,3,2,130,84,117,77,112,193,109,66,157,103,105,74,188,93,87,6,149,167,61,45,138,41,49,78,128,42,57,37,121,162,126,143,160,91,1,33,124,94,196,36,182,92,178,20,23,189,81,0,85,104,31,146,140,9,144,170,95,38,139,19,46,51,50,34,194,180,123,176,67,32,72,163,25,70,65,16,190,11,113,156,71,165,184,174,8,173,18,131,110,101,59,80,100,30,134,148,195,97,58,175,151,7,191,181,68,198,142,137,158,54,52,119,187,39,107,55,14,13,111,132,89,75,4,15,135,53,183,69,159,164,90,28,155,73,99,106,136,115,152,35,161,102,86,133,76,122,116,44,125,145,56,21,108,192,40,169,129,29,154,60,177,27,43,127,96,171,141,98,114,64,79,179,47,88,5,186,199,83,153,166,24,150,10,185,62,120,197,168,17,48,63];82;True
2029;8467;10496;[82,49,122,102,114,60,2,129,135,105,99,73,140,14,192,10,123,17,8,94,173,18,25,120,24,197,15,9,147,143,67,189,117,65,124,178,130,22,38,21,72,154,75,151,7,153,187,127,39,107,101,76,50,53,93,27,30,134,58,86,181,150,23,12,54,158,121,168,3,98,78,110,81,52,146,118,183,83,26,79,185,148,167,61,59,36,46,5,41,133,96,157,138,45,188,87,66,126,106,159,174,1,51,29,198,156,160,71,69,190,43,128,85,164,111,88,40,37,145,139,33,13,172,195,182,109,141,35,6,56,92,194,31,171,152,57,186,113,196,89,162,142,28,74,4,97,131,0,199,62,44,34,108,20,55,155,184,161,80,137,177,169,191,11,104,180,163,170,95,91,90,125,149,32,68,63,100,116,175,165,193,16,136,144,70,19,64,103,112,84,77,115,179,176,42,47,132,166,119,48];83;False
2657;7204;9861;[198,172,12,22,26,118,147,3,2,130,84,117,77,112,193,109,66,157,103,105,74,188,93,87,6,149,167,61,45,138,41,49,78,128,42,57,37,121,162,126,143,160,91,1,33,124,94,196,36,182,92,178,20,23,189,81,0,85,104,31,146,140,9,144,170,95,38,139,19,46,51,50,34,194,180,123,176,67,32,72,163,25,70,65,16,190,11,113,156,71,165,184,174,8,173,18,131,110,101,59,80,100,30,134,148,195,97,58,175,151,7,191,181,68,82,142,137,158,54,52,119,187,39,107,55,14,13,111,132,89,75,4,15,135,53,183,69,159,164,90,28,155,73,99,106,136,115,152,35,161,102,86,133,76,122,116,44,125,145,56,21,108,192,40,169,129,29,154,60,177,27,43,127,96,171,141,98,114,64,79,179,47,88,5,186,199,83,153,166,24,150,10,185,62,120,197,168,17,48,63];84;False
2063;8462;10525;[63,49,122,102,114,60,2,129,135,105,99,73,140,14,192,10,123,17,8,94,173,18,25,120,24,197,15,9,147,143,67,189,117,65,124,178,130,22,38,21,72,154,75,151,7,153,187,127,39,107,101,76,50,53,93,27,30,134,58,86,181,150,23,12,54,158,121,168,3,98,78,110,81,52,146,118,183,83,26,79,185,148,167,61,59,36,46,5,41,133,96,157,138,45,188,87,66,126,106,159,174,1,51,29,198,156,160,71,69,190,43,128,85,164,111,88,40,37,145,139,33,13,172,195,182,109,141,35,6,56,92,194,31,171,152,57,186,113,196,89,162,142,28,74,4,97,131,0,199,62,44,34,108,20,55,155,184,161,80,137,177,169,191,11,104,180,163,170,95,91,90,125,149,32,68,82,100,116,175,165,193,16,136,144,70,19,64,103,112,84,77,115,179,176,42,47,132,166,119,48];85;False
2692;7201;9893;[194,172,12,22,26,118,147,3,2,130,84,117,77,112,193,109,66,157,103,105,74,188,93,87,6,149,167,61,45,138,41,49,78,128,42,57,37,121,162,126,143,160,91,1,33,124,94,196,36,182,92,178,20,23,189,81,0,85,104,31,146,140,9,144,170,95,38,139,19,46,51,50,34,198,180,123,176,67,32,72,163,25,70,65,16,190,11,113,156,71,165,184,174,8,173,18,131,110,101,59,80,100,30,134,148,195,97,58,175,151,7,191,181,68,82,142,137,158,54,52,119,187,39,107,55,14,13,111,132,89,75,4,15,135,53,183,69,159,164,90,28,155,73,99,106,136,115,152,35,161,102,86,133,76,122,116,44,125,145,56,21,108,192,40,169,129,29,154,60,177,27,43,127,96,171,141,98,114,64,79,179,47,88,5,186,199,83,153,166,24,150,10,185,62,120,197,168,17,48,63];86;False
2021;8469;10490;[146,49,122,102,114,60,2,129,135,105,99,73,140,14,192,10,123,17,8,94,173,18,25,120,24,197,15,9,147,143,67,189,117,65,124,178,130,22,38,21,72,154,75,151,7,153,187,127,39,107,101,76,50,53,93,27,30,134,58,86,181,150,23,12,54,158,121,168,3,98,78,110,81,52,63,118,183,83,26,79,185,148,167,61,59,36,46,5,41,133,96,157,138,45,188,87,66,126,106,159,174,1,51,29,198,156,160,71,69,190,43,128,85,164,111,88,40,37,145,139,33,13,172,195,182,109,141,35,6,56,92,194,31,171,152,57,186,113,196,89,162,142,28,74,4,97,131,0,199,62,44,34,108,20,55,155,184,161,80,137,177,169,191,11,104,180,163,170,95,91,90,125,149,32,68,82,100,116,175,165,193,16,136,144,70,19,64,103,112,84,77,115,179,176,42,47,132,166,119,48];87;False
2843;7198;10041;[194,191,12,22,26,118,147,3,2,130,84,117,77,112,193,109,66,157,103,105,74,188,93,87,6,149,167,61,45,138,41,49,78,128,42,57,37,121,162,126,143,160,91,1,33,124,94,196,36,182,92,178,20,23,189,81,0,85,104,31,146,140,9,144,170,95,38,139,19,46,51,50,34,198,180,123,176,67,32,72,163,25,70,65,16,190,11,113,156,71,165,184,174,8,173,18,131,110,101,59,80,100,30,134,148,195,97,58,175,151,7,172,181,68,82,142,137,158,54,52,119,187,39,107,55,14,13,111,132,89,75,4,15,135,53,183,69,159,164,90,28,155,73,99,106,136,115,152,35,161,102,86,133,76,122,116,44,125,145,56,21,108,192,40,169,129,29,154,60,177,27,43,127,96,171,141,98,114,64,79,179,47,88,5,186,199,83,153,166,24,150,10,185,62,120,197,168,17,48,63];88;False
2041;8451;10492;[146,49,76,102,114,60,2,129,135,105,99,73,140,14,192,10,123,17,8,94,173,18,25,120,24,197,15,9,147,143,67,189,117,65,124,178,130,22,38,21,72,154,75,151,7,153,187,127,39,107,101,122,50,53,93,27,30,134,58,86,181,150,23,12,54,158,121,168,3,98,78,110,81,52,63,118,183,83,26,79,185,148,167,61,59,36,46,5,41,133,96,157,138,45,188,87,66,126,106,159,174,1,51,29,198,156,160,71,69,190,43,128,85,164,111,88,40,37,145,139,33,13,172,195,182,109,141,35,6,56,92,194,31,171,152,57,186,113,196,89,162,142,28,74,4,97,131,0,199,62,44,34,108,20,55,155,184,161,80,137,177,169,191,11,104,180,163,170,95,91,90,125,149,32,68,82,100,116,175,165,193,16,136,144,70,19,64,103,112,84,77,115,179,176,42,47,132,166,119,48];89;False
2797;7199;9996;[20,191,12,22,26,118,147,3,2,130,84,117,77,112,193,109,66,157,103,105,74,188,93,87,6,149,167,61,45,138,41,49,78,128,42,57,37,121,162,126,143,160,91,1,33,124,94,196,36,182,92,178,194,23,189,81,0,85,104,31,146,140,9,144,170,95,38,139,19,46,51,50,34,198,180,123,176,67,32,72,163,25,70,65,16,190,11,113,156,71,165,184,174,8,173,18,131,110,101,59,80,100,30,134,148,195,97,58,175,151,7,172,181,68,82,142,137,158,54,52,119,187,39,107,55,14,13,111,132,89,75,4,15,135,53,183,69,159,164,90,28,155,73,99,106,136,115,152,35,161,102,86,133,76,122,116,44,125,145,56,21,108,192,40,169,129,29,154,60,177,27,43,127,96,171,141,98,114,64,79,179,47,88,5,186,199,83,153,166,24,150,10,185,62,120,197,168,17,48,63];90;False
2083;8444;10527;[63,49,76,102,114,60,2,129,135,105,99,73,140,14,192,10,123,17,8,94,173,18,25,120,24,197,15,9,147,143,67,189,117,65,124,178,130,22,38,21,72,154,75,151,7,153,187,127,39,107,101,122,50,53,93,27,30,134,58,86,181,150,23,12,54,158,121,168,3,98,78,110,81,52,146,118,183,83,26,79,185,148,167,61,59,36,46,5,41,133,96,157,138,45,188,87,66,126,106,159,174,1,51,29,198,156,160,71,69,190,43,128,85,164,111,88,40,37,145,139,33,13,172,195,182,109,141,35,6,56,92,194,31,171,152,57,186,113,196,89,162,142,28,74,4,97,131,0,199,62,44,34,108,20,55,155,184,161,80,137,177,169,191,11,104,180,163,170,95,91,90,125,149,32,68,82,100,116,175,165,193,16,136,144,70,19,64,103,112,84,77,115,179,176,42,47,132,166,119,48];91;False
2844;7197;10041;[180,191,12,22,26,118,147,3,2,130,84,117,77,112,193,109,66,157,103,105,74,188,93,87,6,149,167,61,45,138,41,49,78,128,42,57,37,121,162,126,143,160,91,1,33,124,94,196,36,182,92,178,194,23,189,81,0,85,104,31,146,140,9,144,170,95,38,139,19,46,51,50,34,198,20,123,176,67,32,72,163,25,70,65,16,190,11,113,156,71,165,184,174,8,173,18,131,110,101,59,80,100,30,134,148,195,97,58,175,151,7,172,181,68,82,142,137,158,54,52,119,187,39,107,55,14,13,111,132,89,75,4,15,135,53,183,69,159,164,90,28,155,73,99,106,136,115,152,35,161,102,86,133,76,122,116,44,125,145,56,21,108,192,40,169,129,29,154,60,177,27,43,127,96,171,141,98,114,64,79,179,47,88,5,186,199,83,153,166,24,150,10,185,62,120,197,168,17,48,63];92;False
2049;8449;10498;[82,49,76,102,114,60,2,129,135,105,99,73,140,14,192,10,123,17,8,94,173,18,25,120,24,197,15,9,147,143,67,189,117,65,124,178,130,22,38,21,72,154,75,151,7,153,187,127,39,107,101,122,50,53,93,27,30,134,58,86,181,150,23,12,54,158,121,168,3,98,78,110,81,52,146,118,183,83,26,79,185,148,167,61,59,36,46,5,41,133,96,157,138,45,188,87,66,126,106,159,174,1,51,29,198,156,160,71,69,190,43,128,85,164,111,88,40,37,145,139,33,13,172,195,182,109,141,35,6,56,92,194,31,171,152,57,186,113,196,89,162,142,28,74,4,97,131,0,199,62,44,34,108,20,55,155,184,161,80,137,177,169,191,11,104,180,163,170,95,91,90,125,149,32,68,63,100,116,175,165,193,16,136,144,70,19,64,103,112,84,77,115,179,176,42,47,132,166,119,48];93;False
3044;7196;10240;[147,191,12,22,26,118,180,3,2,130,84,117,77,112,193,109,66,157,103,105,74,188,93,87,6,149,167,61,45,138,41,49,78,128,42,57,37,121,162,126,143,160,91,1,33,124,94,196,36,182,92,178,194,23,189,81,0,85,104,31,146,140,9,144,170,95,38,139,19,46,51,50,34,198,20,123,176,67,32,72,163,25,70,65,16,190,11,113,156,71,165,184,174,8,173,18,131,110,101,59,80,100,30,134,148,195,97,58,175,151,7,172,181,68,82,142,137,158,54,52,119,187,39,107,55,14,13,111,132,89,75,4,15,135,53,183,69,159,164,90,28,155,73,99,106,136,115,152,35,161,102,86,133,76,122,116,44,125,145,56,21,108,192,40,169,129,29,154,60,177,27,43,127,96,171,141,98,114,64,79,179,47,88,5,186,199,83,153,166,24,150,10,185,62,120,197,168,17,48,63];94;False
1975;8466;10441;[82,117,76,102,114,60,2,129,135,105,99,73,140,14,192,10,123,17,8,94,173,18,25,120,24,197,15,9,147,143,67,189,49,65,124,178,130,22,38,21,72,154,75,151,7,153,187,127,39,107,101,122,50,53,93,27,30,134,58,86,181,150,23,12,54,158,121,168,3,98,78,110,81,52,146,118,183,83,26,79,185,148,167,61,59,36,46,5,41,133,96,157,138,45,188,87,66,126,106,159,174,1,51,29,198,156,160,71,69,190,43,128,85,164,111,88,40,37,145,139,33,13,172,195,182,109,141,35,6,56,92,194,31,171,152,57,186,113,196,89,162,142,28,74,4,97,131,0,199,62,44,34,108,20,55,155,184,161,80,137,177,169,191,11,104,180,163,170,95,91,90,125,149,32,68,63,100,116,175,165,193,16,136,144,70,19,64,103,112,84,77,115,179,176,42,47,132,166,119,48];95;False
3112;7194;10306;[143,191,12,22,26,118,180,3,2,130,84,117,77,112,193,109,66,157,103,105,74,188,93,87,6,149,167,61,45,138,41,49,78,128,42,57,37,121,162,126,147,160,91,1,33,124,94,196,36,182,92,178,194,23,189,81,0,85,104,31,146,140,9,144,170,95,38,139,19,46,51,50,34,198,20,123,176,67,32,72,163,25,70,65,16,190,11,113,156,71,165,184,174,8,173,18,131,110,101,59,80,100,30,134,148,195,97,58,175,151,7,172,181,68,82,142,137,158,54,52,119,187,39,107,55,14,13,111,132,89,75,4,15,135,53,183,69,159,164,90,28,155,73,99,106,136,115,152,35,161,102,86,133,76,122,116,44,125,145,56,21,108,192,40,169,129,29,154,60,177,27,43,127,96,171,141,98,114,64,79,179,47,88,5,186,199,83,153,166,24,150,10,185,62,120,197,168,17,48,63];96;False
2040;8465;10505;[53,117,76,102,114,60,2,129,135,105,99,73,140,14,192,10,123,17,8,94,173,18,25,120,24,197,15,9,147,143,67,189,49,65,124,178,130,22,38,21,72,154,75,151,7,153,187,127,39,107,101,122,50,82,93,27,30,134,58,86,181,150,23,12,54,158,121,168,3,98,78,110,81,52,146,118,183,83,26,79,185,148,167,61,59,36,46,5,41,133,96,157,138,45,188,87,66,126,106,159,174,1,51,29,198,156,160,71,69,190,43,128,85,164,111,88,40,37,145,139,33,13,172,195,182,109,141,35,6,56,92,194,31,171,152,57,186,113,196,89,162,142,28,74,4,97,131,0,199,62,44,34,108,20,55,155,184,161,80,137,177,169,191,11,104,180,163,170,95,91,90,125,149,32,68,63,100,116,175,165,193,16,136,144,70,19,64,103,112,84,77,115,179,176,42,47,132,166,119,48];97;False
3105;7183;10288;[194,191,12,22,26,118,180,3,2,130,84,117,77,112,193,109,66,157,103,105,74,188,93,87,6,149,167,61,45,138,41,49,78,128,42,57,37,121,162,126,147,160,91,1,33,124,94,196,36,182,92,178,143,23,189,81,0,85,104,31,146,140,9,144,170,95,38,139,19,46,51,50,34,198,20,123,176,67,32,72,163,25,70,65,16,190,11,113,156,71,165,184,174,8,173,18,131,110,101,59,80,100,30,134,148,195,97,58,175,151,7,172,181,68,82,142,137,158,54,52,119,187,39,107,55,14,13,111,132,89,75,4,15,135,53,183,69,159,164,90,28,155,73,99,106,136,115,152,35,161,102,86,133,76,122,116,44,125,145,56,21,108,192,40,169,129,29,154,60,177,27,43,127,96,171,141,98,114,64,79,179,47,88,5,186,199,83,153,166,24,150,10,185,62,120,197,168,17,48,63];98;False
2038;8458;10496;[1,117,76,102,114,60,2,129,135,105,99,73,140,14,192,10,123,17,8,94,173,18,25,120,24,197,15,9,147,143,67,189,49,65,124,178,130,22,38,21,72,154,75,151,7,153,187,127,39,107,101,122,50,82,93,27,30,134,58,86,181,150,23,12,54,158,121,168,3,98,78,110,81,52,146,118,183,83,26,79,185,148,167,61,59,36,46,5,41,133,96,157,138,45,188,87,66,126,106,159,174,53,51,29,198,156,160,71,69,190,43,128,85,164,111,88,40,37,145,139,33,13,172,195,182,109,141,35,6,56,92,194,31,171,152,57,186,113,196,89,162,142,28,74,4,97,131,0,199,62,44,34,108,20,55,155,184,161,80,137,177,169,191,11,104,180,163,170,95,91,90,125,149,32,68,63,100,116,175,165,193,16,136,144,70,19,64,103,112,84,77,115,179,176,42,47,132,166,119,48];99;False
3046;7195;10241;[146,191,12,22,26,118,180,3,2,130,84,117,77,112,193,109,66,157,103,105,74,188,93,87,6,149,167,61,45,138,41,49,78,128,42,57,37,121,162,126,147,160,91,1,33,124,94,196,36,182,92,178,143,23,189,81,0,85,104,31,194,140,9,144,170,95,38,139,19,46,51,50,34,198,20,123,176,67,32,72,163,25,70,65,16,190,11,113,156,71,165,184,174,8,173,18,131,110,101,59,80,100,30,134,148,195,97,58,175,151,7,172,181,68,82,142,137,158,54,52,119,187,39,107,55,14,13,111,132,89,75,4,15,135,53,183,69,159,164,90,28,155,73,99,106,136,115,152,35,161,102,86,133,76,122,116,44,125,145,56,21,108,192,40,169,129,29,154,60,177,27,43,127,96,171,141,98,114,64,79,179,47,88,5,186,199,83,153,166,24,150,10,185,62,120,197,168,17,48,63];100;False
2082;8437;10519;[50,117,76,102,114,60,2,129,135,105,99,73,140,14,192,10,123,17,8,94,173,18,25,120,24,197,15,9,147,143,67,189,49,65,124,178,130,22,38,21,72,154,75,151,7,153,187,127,39,107,101,122,1,82,93,27,30,134,58,86,181,150,23,12,54,158,121,168,3,98,78,110,81,52,146,118,183,83,26,79,185,148,167,61,59,36,46,5,41,133,96,157,138,45,188,87,66,126,106,159,174,53,51,29,198,156,160,71,69,190,43,128,85,164,111,88,40,37,145,139,33,13,172,195,182,109,141,35,6,56,92,194,31,171,152,57,186,113,196,89,162,142,28,74,4,97,131,0,199,62,44,34,108,20,55,155,184,161,80,137,177,169,191,11,104,180,163,170,95,91,90,125,149,32,68,63,100,116,175,165,193,16,136,144,70,19,64,103,112,84,77,115,179,176,42,47,132,166,119,48];101;False
2956;7188;10144;[20,191,12,22,26,118,180,3,2,130,84,117,77,112,193,109,66,157,103,105,74,188,93,87,6,149,167,61,45,138,41,49,78,128,42,57,37,121,162,126,147,160,91,1,33,124,94,196,36,182,92,178,143,23,189,81,0,85,104,31,194,140,9,144,170,95,38,139,19,46,51,50,34,198,146,123,176,67,32,72,163,25,70,65,16,190,11,113,156,71,165,184,174,8,173,18,131,110,101,59,80,100,30,134,148,195,97,58,175,151,7,172,181,68,82,142,137,158,54,52,119,187,39,107,55,14,13,111,132,89,75,4,15,135,53,183,69,159,164,90,28,155,73,99,106,136,115,152,35,161,102,86,133,76,122,116,44,125,145,56,21,108,192,40,169,129,29,154,60,177,27,43,127,96,171,141,98,114,64,79,179,47,88,5,186,199,83,153,166,24,150,10,185,62,120,197,168,17,48,63];102;False
2083;8429;10512;[174,117,76,102,114,60,2,129,135,105,99,73,140,14,192,10,123,17,8,94,173,18,25,120,24,197,15,9,147,143,67,189,49,65,124,178,130,22,38,21,72,154,75,151,7,153,187,127,39,107,101,122,1,82,93,27,30,134,58,86,181,150,23,12,54,158,121,168,3,98,78,110,81,52,146,118,183,83,26,79,185,148,167,61,59,36,46,5,41,133,96,157,138,45,188,87,66,126,106,159,50,53,51,29,198,156,160,71,69,190,43,128,85,164,111,88,40,37,145,139,33,13,172,195,182,109,141,35,6,56,92,194,31,171,152,57,186,113,196,89,162,142,28,74,4,97,131,0,199,62,44,34,108,20,55,155,184,161,80,137,177,169,191,11,104,180,163,170,95,91,90,125,149,32,68,63,100,116,175,165,193,16,136,144,70,19,64,103,112,84,77,115,179,176,42,47,132,166,119,48];103;False
3059;7183;10242;[174,191,12,22,26,118,180,3,2,130,84,117,77,112,193,109,66,157,103,105,74,188,93,87,6,149,167,61,45,138,41,49,78,128,42,57,37,121,162,126,147,160,91,1,33,124,94,196,36,182,92,178,143,23,189,81,0,85,104,31,194,140,9,144,170,95,38,139,19,46,51,50,34,198,146,123,176,67,32,72,163,25,70,65,16,190,11,113,156,71,165,184,20,8,173,18,131,110,101,59,80,100,30,134,148,195,97,58,175,151,7,172,181,68,82,142,137,158,54,52,119,187,39,107,55,14,13,111,132,89,75,4,15,135,53,183,69,159,164,90,28,155,73,99,106,136,115,152,35,161,102,86,133,76,122,116,44,125,145,56,21,108,192,40,169,129,29,154,60,177,27,43,127,96,171,141,98,114,64,79,179,47,88,5,186,199,83,153,166,24,150,10,185,62,120,197,168,17,48,63];104;False
2015;8435;10450;[146,117,76,102,114,60,2,129,135,105,99,73,140,14,192,10,123,17,8,94,173,18,25,120,24,197,15,9,147,143,67,189,49,65,124,178,130,22,38,21,72,154,75,151,7,153,187,127,39,107,101,122,1,82,93,27,30,134,58,86,181,150,23,12,54,158,121,168,3,98,78,110,81,52,174,118,183,83,26,79,185,148,167,61,59,36,46,5,41,133,96,157,138,45,188,87,66,126,106,159,50,53,51,29,198,156,160,71,69,190,43,128,85,164,111,88,40,37,145,139,33,13,172,195,182,109,141,35,6,56,92,194,31,171,152,57,186,113,196,89,162,142,28,74,4,97,131,0,199,62,44,34,108,20,55,155,184,161,80,137,177,169,191,11,104,180,163,170,95,91,90,125,149,32,68,63,100,116,175,165,193,16,136,144,70,19,64,103,112,84,77,115,179,176,42,47,132,166,119,48];105;False
3002;7185;10187;[180,191,12,22,26,118,174,3,2,130,84,117,77,112,193,109,66,157,103,105,74,188,93,87,6,149,167,61,45,138,41,49,78,128,42,57,37,121,162,126,147,160,91,1,33,124,94,196,36,182,92,178,143,23,189,81,0,85,104,31,194,140,9,144,170,95,38,139,19,46,51,50,34,198,146,123,176,67,32,72,163,25,70,65,16,190,11,113,156,71,165,184,20,8,173,18,131,110,101,59,80,100,30,134,148,195,97,58,175,151,7,172,181,68,82,142,137,158,54,52,119,187,39,107,55,14,13,111,132,89,75,4,15,135,53,183,69,159,164,90,28,155,73,99,106,136,115,152,35,161,102,86,133,76,122,116,44,125,145,56,21,108,192,40,169,129,29,154,60,177,27,43,127,96,171,141,98,114,64,79,179,47,88,5,186,199,83,153,166,24,150,10,185,62,120,197,168,17,48,63];106;False
2036;8434;10470;[106,117,76,102,114,60,2,129,135,105,99,73,140,14,192,10,123,17,8,94,173,18,25,120,24,197,15,9,147,143,67,189,49,65,124,178,130,22,38,21,72,154,75,151,7,153,187,127,39,107,101,122,1,82,93,27,30,134,58,86,181,150,23,12,54,158,121,168,3,98,78,110,81,52,174,118,183,83,26,79,185,148,167,61,59,36,46,5,41,133,96,157,138,45,188,87,66,126,146,159,50,53,51,29,198,156,160,71,69,190,43,128,85,164,111,88,40,37,145,139,33,13,172,195,182,109,141,35,6,56,92,194,31,171,152,57,186,113,196,89,162,142,28,74,4,97,131,0,199,62,44,34,108,20,55,155,184,161,80,137,177,169,191,11,104,180,163,170,95,91,90,125,149,32,68,63,100,116,175,165,193,16,136,144,70,19,64,103,112,84,77,115,179,176,42,47,132,166,119,48];107;False
3090;7180;10270;[34,191,12,22,26,118,174,3,2,130,84,117,77,112,193,109,66,157,103,105,74,188,93,87,6,149,167,61,45,138,41,49,78,128,42,57,37,121,162,126,147,160,91,1,33,124,94,196,36,182,92,178,143,23,189,81,0,85,104,31,194,140,9,144,170,95,38,139,19,46,51,50,180,198,146,123,176,67,32,72,163,25,70,65,16,190,11,113,156,71,165,184,20,8,173,18,131,110,101,59,80,100,30,134,148,195,97,58,175,151,7,172,181,68,82,142,137,158,54,52,119,187,39,107,55,14,13,111,132,89,75,4,15,135,53,183,69,159,164,90,28,155,73,99,106,136,115,152,35,161,102,86,133,76,122,116,44,125,145,56,21,108,192,40,169,129,29,154,60,177,27,43,127,96,171,141,98,114,64,79,179,47,88,5,186,199,83,153,166,24,150,10,185,62,120,197,168,17,48,63];108;False
2078;8433;10511;[174,117,76,102,114,60,2,129,135,105,99,73,140,14,192,10,123,17,8,94,173,18,25,120,24,197,15,9,147,143,67,189,49,65,124,178,130,22,38,21,72,154,75,151,7,153,187,127,39,107,101,122,1,82,93,27,30,134,58,86,181,150,23,12,54,158,121,168,3,98,78,110,81,52,106,118,183,83,26,79,185,148,167,61,59,36,46,5,41,133,96,157,138,45,188,87,66,126,146,159,50,53,51,29,198,156,160,71,69,190,43,128,85,164,111,88,40,37,145,139,33,13,172,195,182,109,141,35,6,56,92,194,31,171,152,57,186,113,196,89,162,142,28,74,4,97,131,0,199,62,44,34,108,20,55,155,184,161,80,137,177,169,191,11,104,180,163,170,95,91,90,125,149,32,68,63,100,116,175,165,193,16,136,144,70,19,64,103,112,84,77,115,179,176,42,47,132,166,119,48];109;False
2940;7191;10131;[34,147,12,22,26,118,174,3,2,130,84,117,77,112,193,109,66,157,103,105,74,188,93,87,6,149,167,61,45,138,41,49,78,128,42,57,37,121,162,126,191,160,91,1,33,124,94,196,36,182,92,178,143,23,189,81,0,85,104,31,194,140,9,144,170,95,38,139,19,46,51,50,180,198,146,123,176,67,32,72,163,25,70,65,16,190,11,113,156,71,165,184,20,8,173,18,131,110,101,59,80,100,30,134,148,195,97,58,175,151,7,172,181,68,82,142,137,158,54,52,119,187,39,107,55,14,13,111,132,89,75,4,15,135,53,183,69,159,164,90,28,155,73,99,106,136,115,152,35,161,102,86,133,76,122,116,44,125,145,56,21,108,192,40,169,129,29,154,60,177,27,43,127,96,171,141,98,114,64,79,179,47,88,5,186,199,83,153,166,24,150,10,185,62,120,197,168,17,48,63];110;False
2058;8423;10481;[174,60,76,102,114,117,2,129,135,105,99,73,140,14,192,10,123,17,8,94,173,18,25,120,24,197,15,9,147,143,67,189,49,65,124,178,130,22,38,21,72,154,75,151,7,153,187,127,39,107,101,122,1,82,93,27,30,134,58,86,181,150,23,12,54,158,121,168,3,98,78,110,81,52,106,118,183,83,26,79,185,148,167,61,59,36,46,5,41,133,96,157,138,45,188,87,66,126,146,159,50,53,51,29,198,156,160,71,69,190,43,128,85,164,111,88,40,37,145,139,33,13,172,195,182,109,141,35,6,56,92,194,31,171,152,57,186,113,196,89,162,142,28,74,4,97,131,0,199,62,44,34,108,20,55,155,184,161,80,137,177,169,191,11,104,180,163,170,95,91,90,125,149,32,68,63,100,116,175,165,193,16,136,144,70,19,64,103,112,84,77,115,179,176,42,47,132,166,119,48];111;False
3124;7177;10301;[34,176,12,22,26,118,174,3,2,130,84,117,77,112,193,109,66,157,103,105,74,188,93,87,6,149,167,61,45,138,41,49,78,128,42,57,37,121,162,126,191,160,91,1,33,124,94,196,36,182,92,178,143,23,189,81,0,85,104,31,194,140,9,144,170,95,38,139,19,46,51,50,180,198,146,123,147,67,32,72,163,25,70,65,16,190,11,113,156,71,165,184,20,8,173,18,131,110,101,59,80,100,30,134,148,195,97,58,175,151,7,172,181,68,82,142,137,158,54,52,119,187,39,107,55,14,13,111,132,89,75,4,15,135,53,183,69,159,164,90,28,155,73,99,106,136,115,152,35,161,102,86,133,76,122,116,44,125,145,56,21,108,192,40,169,129,29,154,60,177,27,43,127,96,171,141,98,114,64,79,179,47,88,5,186,199,83,153,166,24,150,10,185,62,120,197,168,17,48,63];112;False
2050;8417;10467;[174,60,101,102,114,117,2,129,135,105,99,73,140,14,192,10,123,17,8,94,173,18,25,120,24,197,15,9,147,143,67,189,49,65,124,178,130,22,38,21,72,154,75,151,7,153,187,127,39,107,76,122,1,82,93,27,30,134,58,86,181,150,23,12,54,158,121,168,3,98,78,110,81,52,106,118,183,83,26,79,185,148,167,61,59,36,46,5,41,133,96,157,138,45,188,87,66,126,146,159,50,53,51,29,198,156,160,71,69,190,43,128,85,164,111,88,40,37,145,139,33,13,172,195,182,109,141,35,6,56,92,194,31,171,152,57,186,113,196,89,162,142,28,74,4,97,131,0,199,62,44,34,108,20,55,155,184,161,80,137,177,169,191,11,104,180,163,170,95,91,90,125,149,32,68,63,100,116,175,165,193,16,136,144,70,19,64,103,112,84,77,115,179,176,42,47,132,166,119,48];113;False
3066;7171;10237;[180,176,12,22,26,118,174,3,2,130,84,117,77,112,193,109,66,157,103,105,74,188,93,87,6,149,167,61,45,138,41,49,78,128,42,57,37,121,162,126,191,160,91,1,33,124,94,196,36,182,92,178,143,23,189,81,0,85,104,31,194,140,9,144,170,95,38,139,19,46,51,50,34,198,146,123,147,67,32,72,163,25,70,65,16,190,11,113,156,71,165,184,20,8,173,18,131,110,101,59,80,100,30,134,148,195,97,58,175,151,7,172,181,68,82,142,137,158,54,52,119,187,39,107,55,14,13,111,132,89,75,4,15,135,53,183,69,159,164,90,28,155,73,99,106,136,115,152,35,161,102,86,133,76,122,116,44,125,145,56,21,108,192,40,169,129,29,154,60,177,27,43,127,96,171,141,98,114,64,79,179,47,88,5,186,199,83,153,166,24,150,10,185,62,120,197,168,17,48,63];114;False
2076;8412;10488;[174,60,119,102,114,117,2,129,135,105,99,73,140,14,192,10,123,17,8,94,173,18,25,120,24,197,15,9,147,143,67,189,49,65,124,178,130,22,38,21,72,154,75,151,7,153,187,127,39,107,76,122,1,82,93,27,30,134,58,86,181,150,23,12,54,158,121,168,3,98,78,110,81,52,106,118,183,83,26,79,185,148,167,61,59,36,46,5,41,133,96,157,138,45,188,87,66,126,146,159,50,53,51,29,198,156,160,71,69,190,43,128,85,164,111,88,40,37,145,139,33,13,172,195,182,109,141,35,6,56,92,194,31,171,152,57,186,113,196,89,162,142,28,74,4,97,131,0,199,62,44,34,108,20,55,155,184,161,80,137,177,169,191,11,104,180,163,170,95,91,90,125,149,32,68,63,100,116,175,165,193,16,136,144,70,19,64,103,112,84,77,115,179,176,42,47,132,166,101,48];115;False
2990;7179;10169;[82,176,12,22,26,118,174,3,2,130,84,117,77,112,193,109,66,157,103,105,74,188,93,87,6,149,167,61,45,138,41,49,78,128,42,57,37,121,162,126,191,160,91,1,33,124,94,196,36,182,92,178,143,23,189,81,0,85,104,31,194,140,9,144,170,95,38,139,19,46,51,50,34,198,146,123,147,67,32,72,163,25,70,65,16,190,11,113,156,71,165,184,20,8,173,18,131,110,101,59,80,100,30,134,148,195,97,58,175,151,7,172,181,68,180,142,137,158,54,52,119,187,39,107,55,14,13,111,132,89,75,4,15,135,53,183,69,159,164,90,28,155,73,99,106,136,115,152,35,161,102,86,133,76,122,116,44,125,145,56,21,108,192,40,169,129,29,154,60,177,27,43,127,96,171,141,98,114,64,79,179,47,88,5,186,199,83,153,166,24,150,10,185,62,120,197,168,17,48,63];116;False
2059;8408;10467;[174,60,119,102,1,117,2,129,135,105,99,73,140,14,192,10,123,17,8,94,173,18,25,120,24,197,15,9,147,143,67,189,49,65,124,178,130,22,38,21,72,154,75,151,7,153,187,127,39,107,76,122,114,82,93,27,30,134,58,86,181,150,23,12,54,158,121,168,3,98,78,110,81,52,106,118,183,83,26,79,185,148,167,61,59,36,46,5,41,133,96,157,138,45,188,87,66,126,146,159,50,53,51,29,198,156,160,71,69,190,43,128,85,164,111,88,40,37,145,139,33,13,172,195,182,109,141,35,6,56,92,194,31,171,152,57,186,113,196,89,162,142,28,74,4,97,131,0,199,62,44,34,108,20,55,155,184,161,80,137,177,169,191,11,104,180,163,170,95,91,90,125,149,32,68,63,100,116,175,165,193,16,136,144,70,19,64,103,112,84,77,115,179,176,42,47,132,166,101,48];117;False
2956;7187;10143;[147,176,12,22,26,118,174,3,2,130,84,117,77,112,193,109,66,157,103,105,74,188,93,87,6,149,167,61,45,138,41,49,78,128,42,57,37,121,162,126,191,160,91,1,33,124,94,196,36,182,92,178,143,23,189,81,0,85,104,31,194,140,9,144,170,95,38,139,19,46,51,50,34,198,146,123,82,67,32,72,163,25,70,65,16,190,11,113,156,71,165,184,20,8,173,18,131,110,101,59,80,100,30,134,148,195,97,58,175,151,7,172,181,68,180,142,137,158,54,52,119,187,39,107,55,14,13,111,132,89,75,4,15,135,53,183,69,159,164,90,28,155,73,99,106,136,115,152,35,161,102,86,133,76,122,116,44,125,145,56,21,108,192,40,169,129,29,154,60,177,27,43,127,96,171,141,98,114,64,79,179,47,88,5,186,199,83,153,166,24,150,10,185,62,120,197,168,17,48,63];118;False
2033;8413;10446;[174,60,101,102,1,117,2,129,135,105,99,73,140,14,192,10,123,17,8,94,173,18,25,120,24,197,15,9,147,143,67,189,49,65,124,178,130,22,38,21,72,154,75,151,7,153,187,127,39,107,76,122,114,82,93,27,30,134,58,86,181,150,23,12,54,158,121,168,3,98,78,110,81,52,106,118,183,83,26,79,185,148,167,61,59,36,46,5,41,133,96,157,138,45,188,87,66,126,146,159,50,53,51,29,198,156,160,71,69,190,43,128,85,164,111,88,40,37,145,139,33,13,172,195,182,109,141,35,6,56,92,194,31,171,152,57,186,113,196,89,162,142,28,74,4,97,131,0,199,62,44,34,108,20,55,155,184,161,80,137,177,169,191,11,104,180,163,170,95,91,90,125,149,32,68,63,100,116,175,165,193,16,136,144,70,19,64,103,112,84,77,115,179,176,42,47,132,166,119,48];119;False
2832;7194;10026;[174,176,12,22,26,118,147,3,2,130,84,117,77,112,193,109,66,157,103,105,74,188,93,87,6,149,167,61,45,138,41,49,78,128,42,57,37,121,162,126,191,160,91,1,33,124,94,196,36,182,92,178,143,23,189,81,0,85,104,31,194,140,9,144,170,95,38,139,19,46,51,50,34,198,146,123,82,67,32,72,163,25,70,65,16,190,11,113,156,71,165,184,20,8,173,18,131,110,101,59,80,100,30,134,148,195,97,58,175,151,7,172,181,68,180,142,137,158,54,52,119,187,39,107,55,14,13,111,132,89,75,4,15,135,53,183,69,159,164,90,28,155,73,99,106,136,115,152,35,161,102,86,133,76,122,116,44,125,145,56,21,108,192,40,169,129,29,154,60,177,27,43,127,96,171,141,98,114,64,79,179,47,88,5,186,199,83,153,166,24,150,10,185,62,120,197,168,17,48,63];120;False
2072;8391;10463;[174,60,101,25,1,117,2,129,135,105,99,73,140,14,192,10,123,17,8,94,173,18,102,120,24,197,15,9,147,143,67,189,49,65,124,178,130,22,38,21,72,154,75,151,7,153,187,127,39,107,76,122,114,82,93,27,30,134,58,86,181,150,23,12,54,158,121,168,3,98,78,110,81,52,106,118,183,83,26,79,185,148,167,61,59,36,46,5,41,133,96,157,138,45,188,87,66,126,146,159,50,53,51,29,198,156,160,71,69,190,43,128,85,164,111,88,40,37,145,139,33,13,172,195,182,109,141,35,6,56,92,194,31,171,152,57,186,113,196,89,162,142,28,74,4,97,131,0,199,62,44,34,108,20,55,155,184,161,80,137,177,169,191,11,104,180,163,170,95,91,90,125,149,32,68,63,100,116,175,165,193,16,136,144,70,19,64,103,112,84,77,115,179,176,42,47,132,166,119,48];121;False
2901;7192;10093;[191,176,12,22,26,118,147,3,2,130,84,117,77,112,193,109,66,157,103,105,74,188,93,87,6,149,167,61,45,138,41,49,78,128,42,57,37,121,162,126,174,160,91,1,33,124,94,196,36,182,92,178,143,23,189,81,0,85,104,31,194,140,9,144,170,95,38,139,19,46,51,50,34,198,146,123,82,67,32,72,163,25,70,65,16,190,11,113,156,71,165,184,20,8,173,18,131,110,101,59,80,100,30,134,148,195,97,58,175,151,7,172,181,68,180,142,137,158,54,52,119,187,39,107,55,14,13,111,132,89,75,4,15,135,53,183,69,159,164,90,28,155,73,99,106,136,115,152,35,161,102,86,133,76,122,116,44,125,145,56,21,108,192,40,169,129,29,154,60,177,27,43,127,96,171,141,98,114,64,79,179,47,88,5,186,199,83,153,166,24,150,10,185,62,120,197,168,17,48,63];122;False
2052;8397;10449;[174,60,76,25,1,117,2,129,135,105,99,73,140,14,192,10,123,17,8,94,173,18,102,120,24,197,15,9,147,143,67,189,49,65,124,178,130,22,38,21,72,154,75,151,7,153,187,127,39,107,101,122,114,82,93,27,30,134,58,86,181,150,23,12,54,158,121,168,3,98,78,110,81,52,106,118,183,83,26,79,185,148,167,61,59,36,46,5,41,133,96,157,138,45,188,87,66,126,146,159,50,53,51,29,198,156,160,71,69,190,43,128,85,164,111,88,40,37,145,139,33,13,172,195,182,109,141,35,6,56,92,194,31,171,152,57,186,113,196,89,162,142,28,74,4,97,131,0,199,62,44,34,108,20,55,155,184,161,80,137,177,169,191,11,104,180,163,170,95,91,90,125,149,32,68,63,100,116,175,165,193,16,136,144,70,19,64,103,112,84,77,115,179,176,42,47,132,166,119,48];123;False
2906;7186;10092;[143,176,12,22,26,118,147,3,2,130,84,117,77,112,193,109,66,157,103,105,74,188,93,87,6,149,167,61,45,138,41,49,78,128,42,57,37,121,162,126,174,160,91,1,33,124,94,196,36,182,92,178,191,23,189,81,0,85,104,31,194,140,9,144,170,95,38,139,19,46,51,50,34,198,146,123,82,67,32,72,163,25,70,65,16,190,11,113,156,71,165,184,20,8,173,18,131,110,101,59,80,100,30,134,148,195,97,58,175,151,7,172,181,68,180,142,137,158,54,52,119,187,39,107,55,14,13,111,132,89,75,4,15,135,53,183,69,159,164,90,28,155,73,99,106,136,115,152,35,161,102,86,133,76,122,116,44,125,145,56,21,108,192,40,169,129,29,154,60,177,27,43,127,96,171,141,98,114,64,79,179,47,88,5,186,199,83,153,166,24,150,10,185,62,120,197,168,17,48,63];124;False
2073;8388;10461;[174,60,177,25,1,117,2,129,135,105,99,73,140,14,192,10,123,17,8,94,173,18,102,120,24,197,15,9,147,143,67,189,49,65,124,178,130,22,38,21,72,154,75,151,7,153,187,127,39,107,101,122,114,82,93,27,30,134,58,86,181,150,23,12,54,158,121,168,3,98,78,110,81,52,106,118,183,83,26,79,185,148,167,61,59,36,46,5,41,133,96,157,138,45,188,87,66,126,146,159,50,53,51,29,198,156,160,71,69,190,43,128,85,164,111,88,40,37,145,139,33,13,172,195,182,109,141,35,6,56,92,194,31,171,152,57,186,113,196,89,162,142,28,74,4,97,131,0,199,62,44,34,108,20,55,155,184,161,80,137,76,169,191,11,104,180,163,170,95,91,90,125,149,32,68,63,100,116,175,165,193,16,136,144,70,19,64,103,112,84,77,115,179,176,42,47,132,166,119,48];125;False
2980;7185;10165;[147,176,12,22,26,118,143,3,2,130,84,117,77,112,193,109,66,157,103,105,74,188,93,87,6,149,167,61,45,138,41,49,78,128,42,57,37,121,162,126,174,160,91,1,33,124,94,196,36,182,92,178,191,23,189,81,0,85,104,31,194,140,9,144,170,95,38,139,19,46,51,50,34,198,146,123,82,67,32,72,163,25,70,65,16,190,11,113,156,71,165,184,20,8,173,18,131,110,101,59,80,100,30,134,148,195,97,58,175,151,7,172,181,68,180,142,137,158,54,52,119,187,39,107,55,14,13,111,132,89,75,4,15,135,53,183,69,159,164,90,28,155,73,99,106,136,115,152,35,161,102,86,133,76,122,116,44,125,145,56,21,108,192,40,169,129,29,154,60,177,27,43,127,96,171,141,98,114,64,79,179,47,88,5,186,199,83,153,166,24,150,10,185,62,120,197,168,17,48,63];126;False
2071;8392;10463;[174,60,177,182,1,117,2,129,135,105,99,73,140,14,192,10,123,17,8,94,173,18,102,120,24,197,15,9,147,143,67,189,49,65,124,178,130,22,38,21,72,154,75,151,7,153,187,127,39,107,101,122,114,82,93,27,30,134,58,86,181,150,23,12,54,158,121,168,3,98,78,110,81,52,106,118,183,83,26,79,185,148,167,61,59,36,46,5,41,133,96,157,138,45,188,87,66,126,146,159,50,53,51,29,198,156,160,71,69,190,43,128,85,164,111,88,40,37,145,139,33,13,172,195,25,109,141,35,6,56,92,194,31,171,152,57,186,113,196,89,162,142,28,74,4,97,131,0,199,62,44,34,108,20,55,155,184,161,80,137,76,169,191,11,104,180,163,170,95,91,90,125,149,32,68,63,100,116,175,165,193,16,136,144,70,19,64,103,112,84,77,115,179,176,42,47,132,166,119,48];127;False
2971;7183;10154;[174,176,12,22,26,118,143,3,2,130,84,117,77,112,193,109,66,157,103,105,74,188,93,87,6,149,167,61,45,138,41,49,78,128,42,57,37,121,162,126,147,160,91,1,33,124,94,196,36,182,92,178,191,23,189,81,0,85,104,31,194,140,9,144,170,95,38,139,19,46,51,50,34,198,146,123,82,67,32,72,163,25,70,65,16,190,11,113,156,71,165,184,20,8,173,18,131,110,101,59,80,100,30,134,148,195,97,58,175,151,7,172,181,68,180,142,137,158,54,52,119,187,39,107,55,14,13,111,132,89,75,4,15,135,53,183,69,159,164,90,28,155,73,99,106,136,115,152,35,161,102,86,133,76,122,116,44,125,145,56,21,108,192,40,169,129,29,154,60,177,27,43,127,96,171,141,98,114,64,79,179,47,88,5,186,199,83,153,166,24,150,10,185,62,120,197,168,17,48,63];128;False
2045;8404;10449;[174,60,76,182,1,117,2,129,135,105,99,73,140,14,192,10,123,17,8,94,173,18,102,120,24,197,15,9,147,143,67,189,49,65,124,178,130,22,38,21,72,154,75,151,7,153,187,127,39,107,101,122,114,82,93,27,30,134,58,86,181,150,23,12,54,158,121,168,3,98,78,110,81,52,106,118,183,83,26,79,185,148,167,61,59,36,46,5,41,133,96,157,138,45,188,87,66,126,146,159,50,53,51,29,198,156,160,71,69,190,43,128,85,164,111,88,40,37,145,139,33,13,172,195,25,109,141,35,6,56,92,194,31,171,152,57,186,113,196,89,162,142,28,74,4,97,131,0,199,62,44,34,108,20,55,155,184,161,80,137,177,169,191,11,104,180,163,170,95,91,90,125,149,32,68,63,100,116,175,165,193,16,136,144,70,19,64,103,112,84,77,115,179,176,42,47,132,166,119,48];129;False
3021;7177;10198;[143,176,12,22,26,118,174,3,2,130,84,117,77,112,193,109,66,157,103,105,74,188,93,87,6,149,167,61,45,138,41,49,78,128,42,57,37,121,162,126,147,160,91,1,33,124,94,196,36,182,92,178,191,23,189,81,0,85,104,31,194,140,9,144,170,95,38,139,19,46,51,50,34,198,146,123,82,67,32,72,163,25,70,65,16,190,11,113,156,71,165,184,20,8,173,18,131,110,101,59,80,100,30,134,148,195,97,58,175,151,7,172,181,68,180,142,137,158,54,52,119,187,39,107,55,14,13,111,132,89,75,4,15,135,53,183,69,159,164,90,28,155,73,99,106,136,115,152,35,161,102,86,133,76,122,116,44,125,145,56,21,108,192,40,169,129,29,154,60,177,27,43,127,96,171,141,98,114,64,79,179,47,88,5,186,199,83,153,166,24,150,10,185,62,120,197,168,17,48,63];130;False
2029;8395;10424;[174,60,101,182,1,117,2,129,135,105,99,73,140,14,192,10,123,17,8,94,173,18,102,120,24,197,15,9,147,143,67,189,49,65,124,178,130,22,38,21,72,154,75,151,7,153,187,127,39,107,76,122,114,82,93,27,30,134,58,86,181,150,23,12,54,158,121,168,3,98,78,110,81,52,106,118,183,83,26,79,185,148,167,61,59,36,46,5,41,133,96,157,138,45,188,87,66,126,146,159,50,53,51,29,198,156,160,71,69,190,43,128,85,164,111,88,40,37,145,139,33,13,172,195,25,109,141,35,6,56,92,194,31,171,152,57,186,113,196,89,162,142,28,74,4,97,131,0,199,62,44,34,108,20,55,155,184,161,80,137,177,169,191,11,104,180,163,170,95,91,90,125,149,32,68,63,100,116,175,165,193,16,136,144,70,19,64,103,112,84,77,115,179,176,42,47,132,166,119,48];131;False
2867;7172;10039;[147,176,12,22,26,118,174,3,2,130,84,117,77,112,193,109,66,157,103,105,74,188,93,87,6,149,167,61,45,138,41,49,78,128,42,57,37,121,162,126,143,160,91,1,33,124,94,196,36,182,92,178,191,23,189,81,0,85,104,31,194,140,9,144,170,95,38,139,19,46,51,50,34,198,146,123,82,67,32,72,163,25,70,65,16,190,11,113,156,71,165,184,20,8,173,18,131,110,101,59,80,100,30,134,148,195,97,58,175,151,7,172,181,68,180,142,137,158,54,52,119,187,39,107,55,14,13,111,132,89,75,4,15,135,53,183,69,159,164,90,28,155,73,99,106,136,115,152,35,161,102,86,133,76,122,116,44,125,145,56,21,108,192,40,169,129,29,154,60,177,27,43,127,96,171,141,98,114,64,79,179,47,88,5,186,199,83,153,166,24,150,10,185,62,120,197,168,17,48,63];132;False
2090;8381;10471;[174,60,93,182,1,117,2,129,135,105,99,73,140,14,192,10,123,17,8,94,173,18,102,120,24,197,15,9,147,143,67,189,49,65,124,178,130,22,38,21,72,154,75,151,7,153,187,127,39,107,76,122,114,82,101,27,30,134,58,86,181,150,23,12,54,158,121,168,3,98,78,110,81,52,106,118,183,83,26,79,185,148,167,61,59,36,46,5,41,133,96,157,138,45,188,87,66,126,146,159,50,53,51,29,198,156,160,71,69,190,43,128,85,164,111,88,40,37,145,139,33,13,172,195,25,109,141,35,6,56,92,194,31,171,152,57,186,113,196,89,162,142,28,74,4,97,131,0,199,62,44,34,108,20,55,155,184,161,80,137,177,169,191,11,104,180,163,170,95,91,90,125,149,32,68,63,100,116,175,165,193,16,136,144,70,19,64,103,112,84,77,115,179,176,42,47,132,166,119,48];133;False
2743;7179;9922;[174,176,12,22,26,118,147,3,2,130,84,117,77,112,193,109,66,157,103,105,74,188,93,87,6,149,167,61,45,138,41,49,78,128,42,57,37,121,162,126,143,160,91,1,33,124,94,196,36,182,92,178,191,23,189,81,0,85,104,31,194,140,9,144,170,95,38,139,19,46,51,50,34,198,146,123,82,67,32,72,163,25,70,65,16,190,11,113,156,71,165,184,20,8,173,18,131,110,101,59,80,100,30,134,148,195,97,58,175,151,7,172,181,68,180,142,137,158,54,52,119,187,39,107,55,14,13,111,132,89,75,4,15,135,53,183,69,159,164,90,28,155,73,99,106,136,115,152,35,161,102,86,133,76,122,116,44,125,145,56,21,108,192,40,169,129,29,154,60,177,27,43,127,96,171,141,98,114,64,79,179,47,88,5,186,199,83,153,166,24,150,10,185,62,120,197,168,17,48,63];134;False
2029;8379;10408;[174,60,147,182,1,117,2,129,135,105,99,73,140,14,192,10,123,17,8,94,173,18,102,120,24,197,15,9,93,143,67,189,49,65,124,178,130,22,38,21,72,154,75,151,7,153,187,127,39,107,76,122,114,82,101,27,30,134,58,86,181,150,23,12,54,158,121,168,3,98,78,110,81,52,106,118,183,83,26,79,185,148,167,61,59,36,46,5,41,133,96,157,138,45,188,87,66,126,146,159,50,53,51,29,198,156,160,71,69,190,43,128,85,164,111,88,40,37,145,139,33,13,172,195,25,109,141,35,6,56,92,194,31,171,152,57,186,113,196,89,162,142,28,74,4,97,131,0,199,62,44,34,108,20,55,155,184,161,80,137,177,169,191,11,104,180,163,170,95,91,90,125,149,32,68,63,100,116,175,165,193,16,136,144,70,19,64,103,112,84,77,115,179,176,42,47,132,166,119,48];135;False
2624;7191;9815;[20,176,12,22,26,118,147,3,2,130,84,117,77,112,193,109,66,157,103,105,74,188,93,87,6,149,167,61,45,138,41,49,78,128,42,57,37,121,162,126,143,160,91,1,33,124,94,196,36,182,92,178,191,23,189,81,0,85,104,31,194,140,9,144,170,95,38,139,19,46,51,50,34,198,146,123,82,67,32,72,163,25,70,65,16,190,11,113,156,71,165,184,174,8,173,18,131,110,101,59,80,100,30,134,148,195,97,58,175,151,7,172,181,68,180,142,137,158,54,52,119,187,39,107,55,14,13,111,132,89,75,4,15,135,53,183,69,159,164,90,28,155,73,99,106,136,115,152,35,161,102,86,133,76,122,116,44,125,145,56,21,108,192,40,169,129,29,154,60,177,27,43,127,96,171,141,98,114,64,79,179,47,88,5,186,199,83,153,166,24,150,10,185,62,120,197,168,17,48,63];136;False
2092;8369;10461;[174,75,147,182,1,117,2,129,135,105,99,73,140,14,192,10,123,17,8,94,173,18,102,120,24,197,15,9,93,143,67,189,49,65,124,178,130,22,38,21,72,154,60,151,7,153,187,127,39,107,76,122,114,82,101,27,30,134,58,86,181,150,23,12,54,158,121,168,3,98,78,110,81,52,106,118,183,83,26,79,185,148,167,61,59,36,46,5,41,133,96,157,138,45,188,87,66,126,146,159,50,53,51,29,198,156,160,71,69,190,43,128,85,164,111,88,40,37,145,139,33,13,172,195,25,109,141,35,6,56,92,194,31,171,152,57,186,113,196,89,162,142,28,74,4,97,131,0,199,62,44,34,108,20,55,155,184,161,80,137,177,169,191,11,104,180,163,170,95,91,90,125,149,32,68,63,100,116,175,165,193,16,136,144,70,19,64,103,112,84,77,115,179,176,42,47,132,166,119,48];137;False
2617;7192;9809;[180,176,12,22,26,118,147,3,2,130,84,117,77,112,193,109,66,157,103,105,74,188,93,87,6,149,167,61,45,138,41,49,78,128,42,57,37,121,162,126,143,160,91,1,33,124,94,196,36,182,92,178,191,23,189,81,0,85,104,31,194,140,9,144,170,95,38,139,19,46,51,50,34,198,146,123,82,67,32,72,163,25,70,65,16,190,11,113,156,71,165,184,174,8,173,18,131,110,101,59,80,100,30,134,148,195,97,58,175,151,7,172,181,68,20,142,137,158,54,52,119,187,39,107,55,14,13,111,132,89,75,4,15,135,53,183,69,159,164,90,28,155,73,99,106,136,115,152,35,161,102,86,133,76,122,116,44,125,145,56,21,108,192,40,169,129,29,154,60,177,27,43,127,96,171,141,98,114,64,79,179,47,88,5,186,199,83,153,166,24,150,10,185,62,120,197,168,17,48,63];138;False
2081;8373;10454;[21,75,147,182,1,117,2,129,135,105,99,73,140,14,192,10,123,17,8,94,173,18,102,120,24,197,15,9,93,143,67,189,49,65,124,178,130,22,38,174,72,154,60,151,7,153,187,127,39,107,76,122,114,82,101,27,30,134,58,86,181,150,23,12,54,158,121,168,3,98,78,110,81,52,106,118,183,83,26,79,185,148,167,61,59,36,46,5,41,133,96,157,138,45,188,87,66,126,146,159,50,53,51,29,198,156,160,71,69,190,43,128,85,164,111,88,40,37,145,139,33,13,172,195,25,109,141,35,6,56,92,194,31,171,152,57,186,113,196,89,162,142,28,74,4,97,131,0,199,62,44,34,108,20,55,155,184,161,80,137,177,169,191,11,104,180,163,170,95,91,90,125,149,32,68,63,100,116,175,165,193,16,136,144,70,19,64,103,112,84,77,115,179,176,42,47,132,166,119,48];139;False
2601;7195;9796;[180,12,176,22,26,118,147,3,2,130,84,117,77,112,193,109,66,157,103,105,74,188,93,87,6,149,167,61,45,138,41,49,78,128,42,57,37,121,162,126,143,160,91,1,33,124,94,196,36,182,92,178,191,23,189,81,0,85,104,31,194,140,9,144,170,95,38,139,19,46,51,50,34,198,146,123,82,67,32,72,163,25,70,65,16,190,11,113,156,71,165,184,174,8,173,18,131,110,101,59,80,100,30,134,148,195,97,58,175,151,7,172,181,68,20,142,137,158,54,52,119,187,39,107,55,14,13,111,132,89,75,4,15,135,53,183,69,159,164,90,28,155,73,99,106,136,115,152,35,161,102,86,133,76,122,116,44,125,145,56,21,108,192,40,169,129,29,154,60,177,27,43,127,96,171,141,98,114,64,79,179,47,88,5,186,199,83,153,166,24,150,10,185,62,120,197,168,17,48,63];140;False
2091;8343;10434;[159,75,147,182,1,117,2,129,135,105,99,73,140,14,192,10,123,17,8,94,173,18,102,120,24,197,15,9,93,143,67,189,49,65,124,178,130,22,38,174,72,154,60,151,7,153,187,127,39,107,76,122,114,82,101,27,30,134,58,86,181,150,23,12,54,158,121,168,3,98,78,110,81,52,106,118,183,83,26,79,185,148,167,61,59,36,46,5,41,133,96,157,138,45,188,87,66,126,146,21,50,53,51,29,198,156,160,71,69,190,43,128,85,164,111,88,40,37,145,139,33,13,172,195,25,109,141,35,6,56,92,194,31,171,152,57,186,113,196,89,162,142,28,74,4,97,131,0,199,62,44,34,108,20,55,155,184,161,80,137,177,169,191,11,104,180,163,170,95,91,90,125,149,32,68,63,100,116,175,165,193,16,136,144,70,19,64,103,112,84,77,115,179,176,42,47,132,166,119,48];141;False
2731;7188;9919;[147,12,176,22,26,118,180,3,2,130,84,117,77,112,193,109,66,157,103,105,74,188,93,87,6,149,167,61,45,138,41,49,78,128,42,57,37,121,162,126,143,160,91,1,33,124,94,196,36,182,92,178,191,23,189,81,0,85,104,31,194,140,9,144,170,95,38,139,19,46,51,50,34,198,146,123,82,67,32,72,163,25,70,65,16,190,11,113,156,71,165,184,174,8,173,18,131,110,101,59,80,100,30,134,148,195,97,58,175,151,7,172,181,68,20,142,137,158,54,52,119,187,39,107,55,14,13,111,132,89,75,4,15,135,53,183,69,159,164,90,28,155,73,99,106,136,115,152,35,161,102,86,133,76,122,116,44,125,145,56,21,108,192,40,169,129,29,154,60,177,27,43,127,96,171,141,98,114,64,79,179,47,88,5,186,199,83,153,166,24,150,10,185,62,120,197,168,17,48,63];142;False
2077;8317;10394;[147,75,159,182,1,117,2,129,135,105,99,73,140,14,192,10,123,17,8,94,173,18,102,120,24,197,15,9,93,143,67,189,49,65,124,178,130,22,38,174,72,154,60,151,7,153,187,127,39,107,76,122,114,82,101,27,30,134,58,86,181,150,23,12,54,158,121,168,3,98,78,110,81,52,106,118,183,83,26,79,185,148,167,61,59,36,46,5,41,133,96,157,138,45,188,87,66,126,146,21,50,53,51,29,198,156,160,71,69,190,43,128,85,164,111,88,40,37,145,139,33,13,172,195,25,109,141,35,6,56,92,194,31,171,152,57,186,113,196,89,162,142,28,74,4,97,131,0,199,62,44,34,108,20,55,155,184,161,80,137,177,169,191,11,104,180,163,170,95,91,90,125,149,32,68,63,100,116,175,165,193,16,136,144,70,19,64,103,112,84,77,115,179,176,42,47,132,166,119,48];143;False
2736;7187;9923;[191,12,176,22,26,118,180,3,2,130,84,117,77,112,193,109,66,157,103,105,74,188,93,87,6,149,167,61,45,138,41,49,78,128,42,57,37,121,162,126,143,160,91,1,33,124,94,196,36,182,92,178,147,23,189,81,0,85,104,31,194,140,9,144,170,95,38,139,19,46,51,50,34,198,146,123,82,67,32,72,163,25,70,65,16,190,11,113,156,71,165,184,174,8,173,18,131,110,101,59,80,100,30,134,148,195,97,58,175,151,7,172,181,68,20,142,137,158,54,52,119,187,39,107,55,14,13,111,132,89,75,4,15,135,53,183,69,159,164,90,28,155,73,99,106,136,115,152,35,161,102,86,133,76,122,116,44,125,145,56,21,108,192,40,169,129,29,154,60,177,27,43,127,96,171,141,98,114,64,79,179,47,88,5,186,199,83,153,166,24,150,10,185,62,120,197,168,17,48,63];144;False
2086;8312;10398;[142,75,159,182,1,117,2,129,135,105,99,73,140,14,192,10,123,17,8,94,173,18,102,120,24,197,15,9,93,143,67,189,49,65,124,178,130,22,38,174,72,154,60,151,7,153,187,127,39,107,76,122,114,82,101,27,30,134,58,86,181,150,23,12,54,158,121,168,3,98,78,110,81,52,106,118,183,83,26,79,185,148,167,61,59,36,46,5,41,133,96,157,138,45,188,87,66,126,146,21,50,53,51,29,198,156,160,71,69,190,43,128,85,164,111,88,40,37,145,139,33,13,172,195,25,109,141,35,6,56,92,194,31,171,152,57,186,113,196,89,162,147,28,74,4,97,131,0,199,62,44,34,108,20,55,155,184,161,80,137,177,169,191,11,104,180,163,170,95,91,90,125,149,32,68,63,100,116,175,165,193,16,136,144,70,19,64,103,112,84,77,115,179,176,42,47,132,166,119,48];145;False
2697;7190;9887;[180,12,176,22,26,118,191,3,2,130,84,117,77,112,193,109,66,157,103,105,74,188,93,87,6,149,167,61,45,138,41,49,78,128,42,57,37,121,162,126,143,160,91,1,33,124,94,196,36,182,92,178,147,23,189,81,0,85,104,31,194,140,9,144,170,95,38,139,19,46,51,50,34,198,146,123,82,67,32,72,163,25,70,65,16,190,11,113,156,71,165,184,174,8,173,18,131,110,101,59,80,100,30,134,148,195,97,58,175,151,7,172,181,68,20,142,137,158,54,52,119,187,39,107,55,14,13,111,132,89,75,4,15,135,53,183,69,159,164,90,28,155,73,99,106,136,115,152,35,161,102,86,133,76,122,116,44,125,145,56,21,108,192,40,169,129,29,154,60,177,27,43,127,96,171,141,98,114,64,79,179,47,88,5,186,199,83,153,166,24,150,10,185,62,120,197,168,17,48,63];146;False
2058;8349;10407;[158,75,159,182,1,117,2,129,135,105,99,73,140,14,192,10,123,17,8,94,173,18,102,120,24,197,15,9,93,143,67,189,49,65,124,178,130,22,38,174,72,154,60,151,7,153,187,127,39,107,76,122,114,82,101,27,30,134,58,86,181,150,23,12,54,142,121,168,3,98,78,110,81,52,106,118,183,83,26,79,185,148,167,61,59,36,46,5,41,133,96,157,138,45,188,87,66,126,146,21,50,53,51,29,198,156,160,71,69,190,43,128,85,164,111,88,40,37,145,139,33,13,172,195,25,109,141,35,6,56,92,194,31,171,152,57,186,113,196,89,162,147,28,74,4,97,131,0,199,62,44,34,108,20,55,155,184,161,80,137,177,169,191,11,104,180,163,170,95,91,90,125,149,32,68,63,100,116,175,165,193,16,136,144,70,19,64,103,112,84,77,115,179,176,42,47,132,166,119,48];147;False
2713;7187;9900;[180,176,12,22,26,118,191,3,2,130,84,117,77,112,193,109,66,157,103,105,74,188,93,87,6,149,167,61,45,138,41,49,78,128,42,57,37,121,162,126,143,160,91,1,33,124,94,196,36,182,92,178,147,23,189,81,0,85,104,31,194,140,9,144,170,95,38,139,19,46,51,50,34,198,146,123,82,67,32,72,163,25,70,65,16,190,11,113,156,71,165,184,174,8,173,18,131,110,101,59,80,100,30,134,148,195,97,58,175,151,7,172,181,68,20,142,137,158,54,52,119,187,39,107,55,14,13,111,132,89,75,4,15,135,53,183,69,159,164,90,28,155,73,99,106,136,115,152,35,161,102,86,133,76,122,116,44,125,145,56,21,108,192,40,169,129,29,154,60,177,27,43,127,96,171,141,98,114,64,79,179,47,88,5,186,199,83,153,166,24,150,10,185,62,120,197,168,17,48,63];148;False
2050;8364;10414;[198,75,159,182,1,117,2,129,135,105,99,73,140,14,192,10,123,17,8,94,173,18,102,120,24,197,15,9,93,143,67,189,49,65,124,178,130,22,38,174,72,154,60,151,7,153,187,127,39,107,76,122,114,82,101,27,30,134,58,86,181,150,23,12,54,142,121,168,3,98,78,110,81,52,106,118,183,83,26,79,185,148,167,61,59,36,46,5,41,133,96,157,138,45,188,87,66,126,146,21,50,53,51,29,158,156,160,71,69,190,43,128,85,164,111,88,40,37,145,139,33,13,172,195,25,109,141,35,6,56,92,194,31,171,152,57,186,113,196,89,162,147,28,74,4,97,131,0,199,62,44,34,108,20,55,155,184,161,80,137,177,169,191,11,104,180,163,170,95,91,90,125,149,32,68,63,100,116,175,165,193,16,136,144,70,19,64,103,112,84,77,115,179,176,42,47,132,166,119,48];149;False
2720;7186;9906;[20,176,12,22,26,118,191,3,2,130,84,117,77,112,193,109,66,157,103,105,74,188,93,87,6,149,167,61,45,138,41,49,78,128,42,57,37,121,162,126,143,160,91,1,33,124,94,196,36,182,92,178,147,23,189,81,0,85,104,31,194,140,9,144,170,95,38,139,19,46,51,50,34,198,146,123,82,67,32,72,163,25,70,65,16,190,11,113,156,71,165,184,174,8,173,18,131,110,101,59,80,100,30,134,148,195,97,58,175,151,7,172,181,68,180,142,137,158,54,52,119,187,39,107,55,14,13,111,132,89,75,4,15,135,53,183,69,159,164,90,28,155,73,99,106,136,115,152,35,161,102,86,133,76,122,116,44,125,145,56,21,108,192,40,169,129,29,154,60,177,27,43,127,96,171,141,98,114,64,79,179,47,88,5,186,199,83,153,166,24,150,10,185,62,120,197,168,17,48,63];150;False
2033;8362;10395;[198,159,75,182,1,117,2,129,135,105,99,73,140,14,192,10,123,17,8,94,173,18,102,120,24,197,15,9,93,143,67,189,49,65,124,178,130,22,38,174,72,154,60,151,7,153,187,127,39,107,76,122,114,82,101,27,30,134,58,86,181,150,23,12,54,142,121,168,3,98,78,110,81,52,106,118,183,83,26,79,185,148,167,61,59,36,46,5,41,133,96,157,138,45,188,87,66,126,146,21,50,53,51,29,158,156,160,71,69,190,43,128,85,164,111,88,40,37,145,139,33,13,172,195,25,109,141,35,6,56,92,194,31,171,152,57,186,113,196,89,162,147,28,74,4,97,131,0,199,62,44,34,108,20,55,155,184,161,80,137,177,169,191,11,104,180,163,170,95,91,90,125,149,32,68,63,100,116,175,165,193,16,136,144,70,19,64,103,112,84,77,115,179,176,42,47,132,166,119,48];151;False
2839;7174;10013;[174,176,12,22,26,118,191,3,2,130,84,117,77,112,193,109,66,157,103,105,74,188,93,87,6,149,167,61,45,138,41,49,78,128,42,57,37,121,162,126,143,160,91,1,33,124,94,196,36,182,92,178,147,23,189,81,0,85,104,31,194,140,9,144,170,95,38,139,19,46,51,50,34,198,146,123,82,67,32,72,163,25,70,65,16,190,11,113,156,71,165,184,20,8,173,18,131,110,101,59,80,100,30,134,148,195,97,58,175,151,7,172,181,68,180,142,137,158,54,52,119,187,39,107,55,14,13,111,132,89,75,4,15,135,53,183,69,159,164,90,28,155,73,99,106,136,115,152,35,161,102,86,133,76,122,116,44,125,145,56,21,108,192,40,169,129,29,154,60,177,27,43,127,96,171,141,98,114,64,79,179,47,88,5,186,199,83,153,166,24,150,10,185,62,120,197,168,17,48,63];152;False
2015;8391;10406;[146,159,75,182,1,117,2,129,135,105,99,73,140,14,192,10,123,17,8,94,173,18,102,120,24,197,15,9,93,143,67,189,49,65,124,178,130,22,38,174,72,154,60,151,7,153,187,127,39,107,76,122,114,82,101,27,30,134,58,86,181,150,23,12,54,142,121,168,3,98,78,110,81,52,106,118,183,83,26,79,185,148,167,61,59,36,46,5,41,133,96,157,138,45,188,87,66,126,198,21,50,53,51,29,158,156,160,71,69,190,43,128,85,164,111,88,40,37,145,139,33,13,172,195,25,109,141,35,6,56,92,194,31,171,152,57,186,113,196,89,162,147,28,74,4,97,131,0,199,62,44,34,108,20,55,155,184,161,80,137,177,169,191,11,104,180,163,170,95,91,90,125,149,32,68,63,100,116,175,165,193,16,136,144,70,19,64,103,112,84,77,115,179,176,42,47,132,166,119,48];153;False
2871;7171;10042;[191,176,12,22,26,118,174,3,2,130,84,117,77,112,193,109,66,157,103,105,74,188,93,87,6,149,167,61,45,138,41,49,78,128,42,57,37,121,162,126,143,160,91,1,33,124,94,196,36,182,92,178,147,23,189,81,0,85,104,31,194,140,9,144,170,95,38,139,19,46,51,50,34,198,146,123,82,67,32,72,163,25,70,65,16,190,11,113,156,71,165,184,20,8,173,18,131,110,101,59,80,100,30,134,148,195,97,58,175,151,7,172,181,68,180,142,137,158,54,52,119,187,39,107,55,14,13,111,132,89,75,4,15,135,53,183,69,159,164,90,28,155,73,99,106,136,115,152,35,161,102,86,133,76,122,116,44,125,145,56,21,108,192,40,169,129,29,154,60,177,27,43,127,96,171,141,98,114,64,79,179,47,88,5,186,199,83,153,166,24,150,10,185,62,120,197,168,17,48,63];154;False
2009;8419;10428;[147,159,75,182,1,117,2,129,135,105,99,73,140,14,192,10,123,17,8,94,173,18,102,120,24,197,15,9,93,143,67,189,49,65,124,178,130,22,38,174,72,154,60,151,7,153,187,127,39,107,76,122,114,82,101,27,30,134,58,86,181,150,23,12,54,142,121,168,3,98,78,110,81,52,106,118,183,83,26,79,185,148,167,61,59,36,46,5,41,133,96,157,138,45,188,87,66,126,198,21,50,53,51,29,158,156,160,71,69,190,43,128,85,164,111,88,40,37,145,139,33,13,172,195,25,109,141,35,6,56,92,194,31,171,152,57,186,113,196,89,162,146,28,74,4,97,131,0,199,62,44,34,108,20,55,155,184,161,80,137,177,169,191,11,104,180,163,170,95,91,90,125,149,32,68,63,100,116,175,165,193,16,136,144,70,19,64,103,112,84,77,115,179,176,42,47,132,166,119,48];155;False
2950;7168;10118;[91,176,12,22,26,118,174,3,2,130,84,117,77,112,193,109,66,157,103,105,74,188,93,87,6,149,167,61,45,138,41,49,78,128,42,57,37,121,162,126,143,160,191,1,33,124,94,196,36,182,92,178,147,23,189,81,0,85,104,31,194,140,9,144,170,95,38,139,19,46,51,50,34,198,146,123,82,67,32,72,163,25,70,65,16,190,11,113,156,71,165,184,20,8,173,18,131,110,101,59,80,100,30,134,148,195,97,58,175,151,7,172,181,68,180,142,137,158,54,52,119,187,39,107,55,14,13,111,132,89,75,4,15,135,53,183,69,159,164,90,28,155,73,99,106,136,115,152,35,161,102,86,133,76,122,116,44,125,145,56,21,108,192,40,169,129,29,154,60,177,27,43,127,96,171,141,98,114,64,79,179,47,88,5,186,199,83,153,166,24,150,10,185,62,120,197,168,17,48,63];156;False
2000;8423;10423;[159,147,75,182,1,117,2,129,135,105,99,73,140,14,192,10,123,17,8,94,173,18,102,120,24,197,15,9,93,143,67,189,49,65,124,178,130,22,38,174,72,154,60,151,7,153,187,127,39,107,76,122,114,82,101,27,30,134,58,86,181,150,23,12,54,142,121,168,3,98,78,110,81,52,106,118,183,83,26,79,185,148,167,61,59,36,46,5,41,133,96,157,138,45,188,87,66,126,198,21,50,53,51,29,158,156,160,71,69,190,43,128,85,164,111,88,40,37,145,139,33,13,172,195,25,109,141,35,6,56,92,194,31,171,152,57,186,113,196,89,162,146,28,74,4,97,131,0,199,62,44,34,108,20,55,155,184,161,80,137,177,169,191,11,104,180,163,170,95,91,90,125,149,32,68,63,100,116,175,165,193,16,136,144,70,19,64,103,112,84,77,115,179,176,42,47,132,166,119,48];157;False
1976;8428;10404;[178,159,75,182,1,117,2,129,135,105,99,73,140,14,192,10,123,17,8,94,173,18,102,120,24,197,15,9,93,143,67,189,49,65,124,147,130,22,38,174,72,154,60,151,7,153,187,127,39,107,76,122,114,82,101,27,30,134,58,86,181,150,23,12,54,142,121,168,3,98,78,110,81,52,106,118,183,83,26,79,185,148,167,61,59,36,46,5,41,133,96,157,138,45,188,87,66,126,198,21,50,53,51,29,158,156,160,71,69,190,43,128,85,164,111,88,40,37,145,139,33,13,172,195,25,109,141,35,6,56,92,194,31,171,152,57,186,113,196,89,162,146,28,74,4,97,131,0,199,62,44,34,108,20,55,155,184,161,80,137,177,169,191,11,104,180,163,170,95,91,90,125,149,32,68,63,100,116,175,165,193,16,136,144,70,19,64,103,112,84,77,115,179,176,42,47,132,166,119,48];158;False
2933;7166;10099;[174,176,12,22,26,118,91,3,2,130,84,117,77,112,193,109,66,157,103,105,74,188,93,87,6,149,167,61,45,138,41,49,78,128,42,57,37,121,162,126,143,160,191,1,33,124,94,196,36,182,92,178,147,23,189,81,0,85,104,31,194,140,9,144,170,95,38,139,19,46,51,50,34,198,146,123,82,67,32,72,163,25,70,65,16,190,11,113,156,71,165,184,20,8,173,18,131,110,101,59,80,100,30,134,148,195,97,58,175,151,7,172,181,68,180,142,137,158,54,52,119,187,39,107,55,14,13,111,132,89,75,4,15,135,53,183,69,159,164,90,28,155,73,99,106,136,115,152,35,161,102,86,133,76,122,116,44,125,145,56,21,108,192,40,169,129,29,154,60,177,27,43,127,96,171,141,98,114,64,79,179,47,88,5,186,199,83,153,166,24,150,10,185,62,120,197,168,17,48,63];159;False
1999;8418;10417;[17,147,75,182,1,117,2,129,135,105,99,73,140,14,192,10,123,159,8,94,173,18,102,120,24,197,15,9,93,143,67,189,49,65,124,178,130,22,38,174,72,154,60,151,7,153,187,127,39,107,76,122,114,82,101,27,30,134,58,86,181,150,23,12,54,142,121,168,3,98,78,110,81,52,106,118,183,83,26,79,185,148,167,61,59,36,46,5,41,133,96,157,138,45,188,87,66,126,198,21,50,53,51,29,158,156,160,71,69,190,43,128,85,164,111,88,40,37,145,139,33,13,172,195,25,109,141,35,6,56,92,194,31,171,152,57,186,113,196,89,162,146,28,74,4,97,131,0,199,62,44,34,108,20,55,155,184,161,80,137,177,169,191,11,104,180,163,170,95,91,90,125,149,32,68,63,100,116,175,165,193,16,136,144,70,19,64,103,112,84,77,115,179,176,42,47,132,166,119,48];160;False
1938;8420;10358;[14,159,75,182,1,117,2,129,135,105,99,73,140,178,192,10,123,17,8,94,173,18,102,120,24,197,15,9,93,143,67,189,49,65,124,147,130,22,38,174,72,154,60,151,7,153,187,127,39,107,76,122,114,82,101,27,30,134,58,86,181,150,23,12,54,142,121,168,3,98,78,110,81,52,106,118,183,83,26,79,185,148,167,61,59,36,46,5,41,133,96,157,138,45,188,87,66,126,198,21,50,53,51,29,158,156,160,71,69,190,43,128,85,164,111,88,40,37,145,139,33,13,172,195,25,109,141,35,6,56,92,194,31,171,152,57,186,113,196,89,162,146,28,74,4,97,131,0,199,62,44,34,108,20,55,155,184,161,80,137,177,169,191,11,104,180,163,170,95,91,90,125,149,32,68,63,100,116,175,165,193,16,136,144,70,19,64,103,112,84,77,115,179,176,42,47,132,166,119,48];161;False
2814;7178;9992;[20,176,12,22,26,118,91,3,2,130,84,117,77,112,193,109,66,157,103,105,74,188,93,87,6,149,167,61,45,138,41,49,78,128,42,57,37,121,162,126,143,160,191,1,33,124,94,196,36,182,92,178,147,23,189,81,0,85,104,31,194,140,9,144,170,95,38,139,19,46,51,50,34,198,146,123,82,67,32,72,163,25,70,65,16,190,11,113,156,71,165,184,174,8,173,18,131,110,101,59,80,100,30,134,148,195,97,58,175,151,7,172,181,68,180,142,137,158,54,52,119,187,39,107,55,14,13,111,132,89,75,4,15,135,53,183,69,159,164,90,28,155,73,99,106,136,115,152,35,161,102,86,133,76,122,116,44,125,145,56,21,108,192,40,169,129,29,154,60,177,27,43,127,96,171,141,98,114,64,79,179,47,88,5,186,199,83,153,166,24,150,10,185,62,120,197,168,17,48,63];162;False
1986;8401;10387;[17,147,75,182,1,117,158,129,135,105,99,73,140,14,192,10,123,159,8,94,173,18,102,120,24,197,15,9,93,143,67,189,49,65,124,178,130,22,38,174,72,154,60,151,7,153,187,127,39,107,76,122,114,82,101,27,30,134,58,86,181,150,23,12,54,142,121,168,3,98,78,110,81,52,106,118,183,83,26,79,185,148,167,61,59,36,46,5,41,133,96,157,138,45,188,87,66,126,198,21,50,53,51,29,2,156,160,71,69,190,43,128,85,164,111,88,40,37,145,139,33,13,172,195,25,109,141,35,6,56,92,194,31,171,152,57,186,113,196,89,162,146,28,74,4,97,131,0,199,62,44,34,108,20,55,155,184,161,80,137,177,169,191,11,104,180,163,170,95,91,90,125,149,32,68,63,100,116,175,165,193,16,136,144,70,19,64,103,112,84,77,115,179,176,42,47,132,166,119,48];163;False
1977;8410;10387;[159,14,75,182,1,117,2,129,135,105,99,73,140,178,192,10,123,17,8,94,173,18,102,120,24,197,15,9,93,143,67,189,49,65,124,147,130,22,38,174,72,154,60,151,7,153,187,127,39,107,76,122,114,82,101,27,30,134,58,86,181,150,23,12,54,142,121,168,3,98,78,110,81,52,106,118,183,83,26,79,185,148,167,61,59,36,46,5,41,133,96,157,138,45,188,87,66,126,198,21,50,53,51,29,158,156,160,71,69,190,43,128,85,164,111,88,40,37,145,139,33,13,172,195,25,109,141,35,6,56,92,194,31,171,152,57,186,113,196,89,162,146,28,74,4,97,131,0,199,62,44,34,108,20,55,155,184,161,80,137,177,169,191,11,104,180,163,170,95,91,90,125,149,32,68,63,100,116,175,165,193,16,136,144,70,19,64,103,112,84,77,115,179,176,42,47,132,166,119,48];164;False
1919;8444;10363;[105,159,75,182,1,117,2,129,135,14,99,73,140,178,192,10,123,17,8,94,173,18,102,120,24,197,15,9,93,143,67,189,49,65,124,147,130,22,38,174,72,154,60,151,7,153,187,127,39,107,76,122,114,82,101,27,30,134,58,86,181,150,23,12,54,142,121,168,3,98,78,110,81,52,106,118,183,83,26,79,185,148,167,61,59,36,46,5,41,133,96,157,138,45,188,87,66,126,198,21,50,53,51,29,158,156,160,71,69,190,43,128,85,164,111,88,40,37,145,139,33,13,172,195,25,109,141,35,6,56,92,194,31,171,152,57,186,113,196,89,162,146,28,74,4,97,131,0,199,62,44,34,108,20,55,155,184,161,80,137,177,169,191,11,104,180,163,170,95,91,90,125,149,32,68,63,100,116,175,165,193,16,136,144,70,19,64,103,112,84,77,115,179,176,42,47,132,166,119,48];165;False
2828;7168;9996;[20,91,12,22,26,118,176,3,2,130,84,117,77,112,193,109,66,157,103,105,74,188,93,87,6,149,167,61,45,138,41,49,78,128,42,57,37,121,162,126,143,160,191,1,33,124,94,196,36,182,92,178,147,23,189,81,0,85,104,31,194,140,9,144,170,95,38,139,19,46,51,50,34,198,146,123,82,67,32,72,163,25,70,65,16,190,11,113,156,71,165,184,174,8,173,18,131,110,101,59,80,100,30,134,148,195,97,58,175,151,7,172,181,68,180,142,137,158,54,52,119,187,39,107,55,14,13,111,132,89,75,4,15,135,53,183,69,159,164,90,28,155,73,99,106,136,115,152,35,161,102,86,133,76,122,116,44,125,145,56,21,108,192,40,169,129,29,154,60,177,27,43,127,96,171,141,98,114,64,79,179,47,88,5,186,199,83,153,166,24,150,10,185,62,120,197,168,17,48,63];166;False
2014;8393;10407;[92,147,75,182,1,117,158,129,135,105,99,73,140,14,192,10,123,159,8,94,173,18,102,120,24,197,15,9,93,143,67,189,49,65,124,178,130,22,38,174,72,154,60,151,7,153,187,127,39,107,76,122,114,82,101,27,30,134,58,86,181,150,23,12,54,142,121,168,3,98,78,110,81,52,106,118,183,83,26,79,185,148,167,61,59,36,46,5,41,133,96,157,138,45,188,87,66,126,198,21,50,53,51,29,2,156,160,71,69,190,43,128,85,164,111,88,40,37,145,139,33,13,172,195,25,109,141,35,6,56,17,194,31,171,152,57,186,113,196,89,162,146,28,74,4,97,131,0,199,62,44,34,108,20,55,155,184,161,80,137,177,169,191,11,104,180,163,170,95,91,90,125,149,32,68,63,100,116,175,165,193,16,136,144,70,19,64,103,112,84,77,115,179,176,42,47,132,166,119,48];167;False
1935;8426;10361;[75,14,159,182,1,117,2,129,135,105,99,73,140,178,192,10,123,17,8,94,173,18,102,120,24,197,15,9,93,143,67,189,49,65,124,147,130,22,38,174,72,154,60,151,7,153,187,127,39,107,76,122,114,82,101,27,30,134,58,86,181,150,23,12,54,142,121,168,3,98,78,110,81,52,106,118,183,83,26,79,185,148,167,61,59,36,46,5,41,133,96,157,138,45,188,87,66,126,198,21,50,53,51,29,158,156,160,71,69,190,43,128,85,164,111,88,40,37,145,139,33,13,172,195,25,109,141,35,6,56,92,194,31,171,152,57,186,113,196,89,162,146,28,74,4,97,131,0,199,62,44,34,108,20,55,155,184,161,80,137,177,169,191,11,104,180,163,170,95,91,90,125,149,32,68,63,100,116,175,165,193,16,136,144,70,19,64,103,112,84,77,115,179,176,42,47,132,166,119,48];168;False
1967;8403;10370;[159,105,75,182,1,117,2,129,135,14,99,73,140,178,192,10,123,17,8,94,173,18,102,120,24,197,15,9,93,143,67,189,49,65,124,147,130,22,38,174,72,154,60,151,7,153,187,127,39,107,76,122,114,82,101,27,30,134,58,86,181,150,23,12,54,142,121,168,3,98,78,110,81,52,106,118,183,83,26,79,185,148,167,61,59,36,46,5,41,133,96,157,138,45,188,87,66,126,198,21,50,53,51,29,158,156,160,71,69,190,43,128,85,164,111,88,40,37,145,139,33,13,172,195,25,109,141,35,6,56,92,194,31,171,152,57,186,113,196,89,162,146,28,74,4,97,131,0,199,62,44,34,108,20,55,155,184,161,80,137,177,169,191,11,104,180,163,170,95,91,90,125,149,32,68,63,100,116,175,165,193,16,136,144,70,19,64,103,112,84,77,115,179,176,42,47,132,166,119,48];169;False
1970;8401;10371;[174,159,75,182,1,117,2,129,135,14,99,73,140,178,192,10,123,17,8,94,173,18,102,120,24,197,15,9,93,143,67,189,49,65,124,147,130,22,38,105,72,154,60,151,7,153,187,127,39,107,76,122,114,82,101,27,30,134,58,86,181,150,23,12,54,142,121,168,3,98,78,110,81,52,106,118,183,83,26,79,185,148,167,61,59,36,46,5,41,133,96,157,138,45,188,87,66,126,198,21,50,53,51,29,158,156,160,71,69,190,43,128,85,164,111,88,40,37,145,139,33,13,172,195,25,109,141,35,6,56,92,194,31,171,152,57,186,113,196,89,162,146,28,74,4,97,131,0,199,62,44,34,108,20,55,155,184,161,80,137,177,169,191,11,104,180,163,170,95,91,90,125,149,32,68,63,100,116,175,165,193,16,136,144,70,19,64,103,112,84,77,115,179,176,42,47,132,166,119,48];170;False
2824;7173;9997;[16,91,12,22,26,118,176,3,2,130,84,117,77,112,193,109,66,157,103,105,74,188,93,87,6,149,167,61,45,138,41,49,78,128,42,57,37,121,162,126,143,160,191,1,33,124,94,196,36,182,92,178,147,23,189,81,0,85,104,31,194,140,9,144,170,95,38,139,19,46,51,50,34,198,146,123,82,67,32,72,163,25,70,65,20,190,11,113,156,71,165,184,174,8,173,18,131,110,101,59,80,100,30,134,148,195,97,58,175,151,7,172,181,68,180,142,137,158,54,52,119,187,39,107,55,14,13,111,132,89,75,4,15,135,53,183,69,159,164,90,28,155,73,99,106,136,115,152,35,161,102,86,133,76,122,116,44,125,145,56,21,108,192,40,169,129,29,154,60,177,27,43,127,96,171,141,98,114,64,79,179,47,88,5,186,199,83,153,166,24,150,10,185,62,120,197,168,17,48,63];171;False
1998;8399;10397;[92,147,75,112,1,117,158,129,135,105,99,73,140,14,192,10,123,159,8,94,173,18,102,120,24,197,15,9,93,143,67,189,49,65,124,178,130,22,38,174,72,154,60,151,7,153,187,127,39,107,76,122,114,82,101,27,30,134,58,86,181,150,23,12,54,142,121,168,3,98,78,110,81,52,106,118,183,83,26,79,185,148,167,61,59,36,46,5,41,133,96,157,138,45,188,87,66,126,198,21,50,53,51,29,2,156,160,71,69,190,43,128,85,164,111,88,40,37,145,139,33,13,172,195,25,109,141,35,6,56,17,194,31,171,152,57,186,113,196,89,162,146,28,74,4,97,131,0,199,62,44,34,108,20,55,155,184,161,80,137,177,169,191,11,104,180,163,170,95,91,90,125,149,32,68,63,100,116,175,165,193,16,136,144,70,19,64,103,182,84,77,115,179,176,42,47,132,166,119,48];172;False
1944;8412;10356;[102,14,159,182,1,117,2,129,135,105,99,73,140,178,192,10,123,17,8,94,173,18,75,120,24,197,15,9,93,143,67,189,49,65,124,147,130,22,38,174,72,154,60,151,7,153,187,127,39,107,76,122,114,82,101,27,30,134,58,86,181,150,23,12,54,142,121,168,3,98,78,110,81,52,106,118,183,83,26,79,185,148,167,61,59,36,46,5,41,133,96,157,138,45,188,87,66,126,198,21,50,53,51,29,158,156,160,71,69,190,43,128,85,164,111,88,40,37,145,139,33,13,172,195,25,109,141,35,6,56,92,194,31,171,152,57,186,113,196,89,162,146,28,74,4,97,131,0,199,62,44,34,108,20,55,155,184,161,80,137,177,169,191,11,104,180,163,170,95,91,90,125,149,32,68,63,100,116,175,165,193,16,136,144,70,19,64,103,112,84,77,115,179,176,42,47,132,166,119,48];173;False
1913;8431;10344;[21,105,75,182,1,117,2,129,135,14,99,73,140,178,192,10,123,17,8,94,173,18,102,120,24,197,15,9,93,143,67,189,49,65,124,147,130,22,38,174,72,154,60,151,7,153,187,127,39,107,76,122,114,82,101,27,30,134,58,86,181,150,23,12,54,142,121,168,3,98,78,110,81,52,106,118,183,83,26,79,185,148,167,61,59,36,46,5,41,133,96,157,138,45,188,87,66,126,198,159,50,53,51,29,158,156,160,71,69,190,43,128,85,164,111,88,40,37,145,139,33,13,172,195,25,109,141,35,6,56,92,194,31,171,152,57,186,113,196,89,162,146,28,74,4,97,131,0,199,62,44,34,108,20,55,155,184,161,80,137,177,169,191,11,104,180,163,170,95,91,90,125,149,32,68,63,100,116,175,165,193,16,136,144,70,19,64,103,112,84,77,115,179,176,42,47,132,166,119,48];174;False
1904;8432;10336;[75,159,174,182,1,117,2,129,135,14,99,73,140,178,192,10,123,17,8,94,173,18,102,120,24,197,15,9,93,143,67,189,49,65,124,147,130,22,38,105,72,154,60,151,7,153,187,127,39,107,76,122,114,82,101,27,30,134,58,86,181,150,23,12,54,142,121,168,3,98,78,110,81,52,106,118,183,83,26,79,185,148,167,61,59,36,46,5,41,133,96,157,138,45,188,87,66,126,198,21,50,53,51,29,158,156,160,71,69,190,43,128,85,164,111,88,40,37,145,139,33,13,172,195,25,109,141,35,6,56,92,194,31,171,152,57,186,113,196,89,162,146,28,74,4,97,131,0,199,62,44,34,108,20,55,155,184,161,80,137,177,169,191,11,104,180,163,170,95,91,90,125,149,32,68,63,100,116,175,165,193,16,136,144,70,19,64,103,112,84,77,115,179,176,42,47,132,166,119,48];175;False
2810;7177;9987;[16,191,12,22,26,118,176,3,2,130,84,117,77,112,193,109,66,157,103,105,74,188,93,87,6,149,167,61,45,138,41,49,78,128,42,57,37,121,162,126,143,160,91,1,33,124,94,196,36,182,92,178,147,23,189,81,0,85,104,31,194,140,9,144,170,95,38,139,19,46,51,50,34,198,146,123,82,67,32,72,163,25,70,65,20,190,11,113,156,71,165,184,174,8,173,18,131,110,101,59,80,100,30,134,148,195,97,58,175,151,7,172,181,68,180,142,137,158,54,52,119,187,39,107,55,14,13,111,132,89,75,4,15,135,53,183,69,159,164,90,28,155,73,99,106,136,115,152,35,161,102,86,133,76,122,116,44,125,145,56,21,108,192,40,169,129,29,154,60,177,27,43,127,96,171,141,98,114,64,79,179,47,88,5,186,199,83,153,166,24,150,10,185,62,120,197,168,17,48,63];176;False
2013;8394;10407;[92,147,75,112,1,88,158,129,135,105,99,73,140,14,192,10,123,159,8,94,173,18,102,120,24,197,15,9,93,143,67,189,49,65,124,178,130,22,38,174,72,154,60,151,7,153,187,127,39,107,76,122,114,82,101,27,30,134,58,86,181,150,23,12,54,142,121,168,3,98,78,110,81,52,106,118,183,83,26,79,185,148,167,61,59,36,46,5,41,133,96,157,138,45,188,87,66,126,198,21,50,53,51,29,2,156,160,71,69,190,43,128,85,164,111,117,40,37,145,139,33,13,172,195,25,109,141,35,6,56,17,194,31,171,152,57,186,113,196,89,162,146,28,74,4,97,131,0,199,62,44,34,108,20,55,155,184,161,80,137,177,169,191,11,104,180,163,170,95,91,90,125,149,32,68,63,100,116,175,165,193,16,136,144,70,19,64,103,182,84,77,115,179,176,42,47,132,166,119,48];177;False
2021;8385;10406;[156,14,159,182,1,117,2,129,135,105,99,73,140,178,192,10,123,17,8,94,173,18,75,120,24,197,15,9,93,143,67,189,49,65,124,147,130,22,38,174,72,154,60,151,7,153,187,127,39,107,76,122,114,82,101,27,30,134,58,86,181,150,23,12,54,142,121,168,3,98,78,110,81,52,106,118,183,83,26,79,185,148,167,61,59,36,46,5,41,133,96,157,138,45,188,87,66,126,198,21,50,53,51,29,158,102,160,71,69,190,43,128,85,164,111,88,40,37,145,139,33,13,172,195,25,109,141,35,6,56,92,194,31,171,152,57,186,113,196,89,162,146,28,74,4,97,131,0,199,62,44,34,108,20,55,155,184,161,80,137,177,169,191,11,104,180,163,170,95,91,90,125,149,32,68,63,100,116,175,165,193,16,136,144,70,19,64,103,112,84,77,115,179,176,42,47,132,166,119,48];178;False
1868;8450;10318;[135,105,75,182,1,117,2,129,21,14,99,73,140,178,192,10,123,17,8,94,173,18,102,120,24,197,15,9,93,143,67,189,49,65,124,147,130,22,38,174,72,154,60,151,7,153,187,127,39,107,76,122,114,82,101,27,30,134,58,86,181,150,23,12,54,142,121,168,3,98,78,110,81,52,106,118,183,83,26,79,185,148,167,61,59,36,46,5,41,133,96,157,138,45,188,87,66,126,198,159,50,53,51,29,158,156,160,71,69,190,43,128,85,164,111,88,40,37,145,139,33,13,172,195,25,109,141,35,6,56,92,194,31,171,152,57,186,113,196,89,162,146,28,74,4,97,131,0,199,62,44,34,108,20,55,155,184,161,80,137,177,169,191,11,104,180,163,170,95,91,90,125,149,32,68,63,100,116,175,165,193,16,136,144,70,19,64,103,112,84,77,115,179,176,42,47,132,166,119,48];179;False
1951;8389;10340;[82,159,174,182,1,117,2,129,135,14,99,73,140,178,192,10,123,17,8,94,173,18,102,120,24,197,15,9,93,143,67,189,49,65,124,147,130,22,38,105,72,154,60,151,7,153,187,127,39,107,76,122,114,75,101,27,30,134,58,86,181,150,23,12,54,142,121,168,3,98,78,110,81,52,106,118,183,83,26,79,185,148,167,61,59,36,46,5,41,133,96,157,138,45,188,87,66,126,198,21,50,53,51,29,158,156,160,71,69,190,43,128,85,164,111,88,40,37,145,139,33,13,172,195,25,109,141,35,6,56,92,194,31,171,152,57,186,113,196,89,162,146,28,74,4,97,131,0,199,62,44,34,108,20,55,155,184,161,80,137,177,169,191,11,104,180,163,170,95,91,90,125,149,32,68,63,100,116,175,165,193,16,136,144,70,19,64,103,112,84,77,115,179,176,42,47,132,166,119,48];180;False
2736;7170;9906;[20,191,12,22,26,118,176,3,2,130,84,117,77,112,193,109,66,157,103,105,74,188,93,87,6,149,167,61,45,138,41,49,78,128,42,57,37,121,162,126,143,160,91,1,33,124,94,196,36,182,92,178,147,23,189,81,0,85,104,31,194,140,9,144,170,95,38,139,19,46,51,50,34,198,146,123,82,67,32,72,163,25,70,65,16,190,11,113,156,71,165,184,174,8,173,18,131,110,101,59,80,100,30,134,148,195,97,58,175,151,7,172,181,68,180,142,137,158,54,52,119,187,39,107,55,14,13,111,132,89,75,4,15,135,53,183,69,159,164,90,28,155,73,99,106,136,115,152,35,161,102,86,133,76,122,116,44,125,145,56,21,108,192,40,169,129,29,154,60,177,27,43,127,96,171,141,98,114,64,79,179,47,88,5,186,199,83,153,166,24,150,10,185,62,120,197,168,17,48,63];181;False
2002;8377;10379;[124,14,159,182,1,117,2,129,135,105,99,73,140,178,192,10,123,17,8,94,173,18,75,120,24,197,15,9,93,143,67,189,49,65,156,147,130,22,38,174,72,154,60,151,7,153,187,127,39,107,76,122,114,82,101,27,30,134,58,86,181,150,23,12,54,142,121,168,3,98,78,110,81,52,106,118,183,83,26,79,185,148,167,61,59,36,46,5,41,133,96,157,138,45,188,87,66,126,198,21,50,53,51,29,158,102,160,71,69,190,43,128,85,164,111,88,40,37,145,139,33,13,172,195,25,109,141,35,6,56,92,194,31,171,152,57,186,113,196,89,162,146,28,74,4,97,131,0,199,62,44,34,108,20,55,155,184,161,80,137,177,169,191,11,104,180,163,170,95,91,90,125,149,32,68,63,100,116,175,165,193,16,136,144,70,19,64,103,112,84,77,115,179,176,42,47,132,166,119,48];182;False
1836;8451;10287;[72,105,75,182,1,117,2,129,21,14,99,73,140,178,192,10,123,17,8,94,173,18,102,120,24,197,15,9,93,143,67,189,49,65,124,147,130,22,38,174,135,154,60,151,7,153,187,127,39,107,76,122,114,82,101,27,30,134,58,86,181,150,23,12,54,142,121,168,3,98,78,110,81,52,106,118,183,83,26,79,185,148,167,61,59,36,46,5,41,133,96,157,138,45,188,87,66,126,198,159,50,53,51,29,158,156,160,71,69,190,43,128,85,164,111,88,40,37,145,139,33,13,172,195,25,109,141,35,6,56,92,194,31,171,152,57,186,113,196,89,162,146,28,74,4,97,131,0,199,62,44,34,108,20,55,155,184,161,80,137,177,169,191,11,104,180,163,170,95,91,90,125,149,32,68,63,100,116,175,165,193,16,136,144,70,19,64,103,112,84,77,115,179,176,42,47,132,166,119,48];183;False
1921;8427;10348;[150,159,174,182,1,117,2,129,135,14,99,73,140,178,192,10,123,17,8,94,173,18,102,120,24,197,15,9,93,143,67,189,49,65,124,147,130,22,38,105,72,154,60,151,7,153,187,127,39,107,76,122,114,75,101,27,30,134,58,86,181,82,23,12,54,142,121,168,3,98,78,110,81,52,106,118,183,83,26,79,185,148,167,61,59,36,46,5,41,133,96,157,138,45,188,87,66,126,198,21,50,53,51,29,158,156,160,71,69,190,43,128,85,164,111,88,40,37,145,139,33,13,172,195,25,109,141,35,6,56,92,194,31,171,152,57,186,113,196,89,162,146,28,74,4,97,131,0,199,62,44,34,108,20,55,155,184,161,80,137,177,169,191,11,104,180,163,170,95,91,90,125,149,32,68,63,100,116,175,165,193,16,136,144,70,19,64,103,112,84,77,115,179,176,42,47,132,166,119,48];184;False
2731;7185;9916;[74,191,12,22,26,118,176,3,2,130,84,117,77,112,193,109,66,157,103,105,20,188,93,87,6,149,167,61,45,138,41,49,78,128,42,57,37,121,162,126,143,160,91,1,33,124,94,196,36,182,92,178,147,23,189,81,0,85,104,31,194,140,9,144,170,95,38,139,19,46,51,50,34,198,146,123,82,67,32,72,163,25,70,65,16,190,11,113,156,71,165,184,174,8,173,18,131,110,101,59,80,100,30,134,148,195,97,58,175,151,7,172,181,68,180,142,137,158,54,52,119,187,39,107,55,14,13,111,132,89,75,4,15,135,53,183,69,159,164,90,28,155,73,99,106,136,115,152,35,161,102,86,133,76,122,116,44,125,145,56,21,108,192,40,169,129,29,154,60,177,27,43,127,96,171,141,98,114,64,79,179,47,88,5,186,199,83,153,166,24,150,10,185,62,120,197,168,17,48,63];185;False
2025;8373;10398;[183,14,159,182,1,117,2,129,135,105,99,73,140,178,192,10,123,17,8,94,173,18,75,120,24,197,15,9,93,143,67,189,49,65,156,147,130,22,38,174,72,154,60,151,7,153,187,127,39,107,76,122,114,82,101,27,30,134,58,86,181,150,23,12,54,142,121,168,3,98,78,110,81,52,106,118,124,83,26,79,185,148,167,61,59,36,46,5,41,133,96,157,138,45,188,87,66,126,198,21,50,53,51,29,158,102,160,71,69,190,43,128,85,164,111,88,40,37,145,139,33,13,172,195,25,109,141,35,6,56,92,194,31,171,152,57,186,113,196,89,162,146,28,74,4,97,131,0,199,62,44,34,108,20,55,155,184,161,80,137,177,169,191,11,104,180,163,170,95,91,90,125,149,32,68,63,100,116,175,165,193,16,136,144,70,19,64,103,112,84,77,115,179,176,42,47,132,166,119,48];186;False
1859;8439;10298;[21,105,75,182,1,117,2,129,72,14,99,73,140,178,192,10,123,17,8,94,173,18,102,120,24,197,15,9,93,143,67,189,49,65,124,147,130,22,38,174,135,154,60,151,7,153,187,127,39,107,76,122,114,82,101,27,30,134,58,86,181,150,23,12,54,142,121,168,3,98,78,110,81,52,106,118,183,83,26,79,185,148,167,61,59,36,46,5,41,133,96,157,138,45,188,87,66,126,198,159,50,53,51,29,158,156,160,71,69,190,43,128,85,164,111,88,40,37,145,139,33,13,172,195,25,109,141,35,6,56,92,194,31,171,152,57,186,113,196,89,162,146,28,74,4,97,131,0,199,62,44,34,108,20,55,155,184,161,80,137,177,169,191,11,104,180,163,170,95,91,90,125,149,32,68,63,100,116,175,165,193,16,136,144,70,19,64,103,112,84,77,115,179,176,42,47,132,166,119,48];187;False
1898;8437;10335;[93,159,174,182,1,117,2,129,135,14,99,73,140,178,192,10,123,17,8,94,173,18,102,120,24,197,15,9,150,143,67,189,49,65,124,147,130,22,38,105,72,154,60,151,7,153,187,127,39,107,76,122,114,75,101,27,30,134,58,86,181,82,23,12,54,142,121,168,3,98,78,110,81,52,106,118,183,83,26,79,185,148,167,61,59,36,46,5,41,133,96,157,138,45,188,87,66,126,198,21,50,53,51,29,158,156,160,71,69,190,43,128,85,164,111,88,40,37,145,139,33,13,172,195,25,109,141,35,6,56,92,194,31,171,152,57,186,113,196,89,162,146,28,74,4,97,131,0,199,62,44,34,108,20,55,155,184,161,80,137,177,169,191,11,104,180,163,170,95,91,90,125,149,32,68,63,100,116,175,165,193,16,136,144,70,19,64,103,112,84,77,115,179,176,42,47,132,166,119,48];188;False
2672;7179;9851;[194,191,12,22,26,118,176,3,2,130,84,117,77,112,193,109,66,157,103,105,20,188,93,87,6,149,167,61,45,138,41,49,78,128,42,57,37,121,162,126,143,160,91,1,33,124,94,196,36,182,92,178,147,23,189,81,0,85,104,31,74,140,9,144,170,95,38,139,19,46,51,50,34,198,146,123,82,67,32,72,163,25,70,65,16,190,11,113,156,71,165,184,174,8,173,18,131,110,101,59,80,100,30,134,148,195,97,58,175,151,7,172,181,68,180,142,137,158,54,52,119,187,39,107,55,14,13,111,132,89,75,4,15,135,53,183,69,159,164,90,28,155,73,99,106,136,115,152,35,161,102,86,133,76,122,116,44,125,145,56,21,108,192,40,169,129,29,154,60,177,27,43,127,96,171,141,98,114,64,79,179,47,88,5,186,199,83,153,166,24,150,10,185,62,120,197,168,17,48,63];189;False
2023;8360;10383;[20,14,159,182,1,117,2,129,135,105,99,73,140,178,192,10,123,17,8,94,173,18,75,120,24,197,15,9,93,143,67,189,49,65,156,147,130,22,38,174,72,154,60,151,7,153,187,127,39,107,76,122,114,82,101,27,30,134,58,86,181,150,23,12,54,142,121,168,3,98,78,110,81,52,106,118,124,83,26,79,185,148,167,61,59,36,46,5,41,133,96,157,138,45,188,87,66,126,198,21,50,53,51,29,158,102,160,71,69,190,43,128,85,164,111,88,40,37,145,139,33,13,172,195,25,109,141,35,6,56,92,194,31,171,152,57,186,113,196,89,162,146,28,74,4,97,131,0,199,62,44,34,108,183,55,155,184,161,80,137,177,169,191,11,104,180,163,170,95,91,90,125,149,32,68,63,100,116,175,165,193,16,136,144,70,19,64,103,112,84,77,115,179,176,42,47,132,166,119,48];190;False
1913;8411;10324;[159,105,75,182,1,117,2,129,72,14,99,73,140,178,192,10,123,17,8,94,173,18,102,120,24,197,15,9,93,143,67,189,49,65,124,147,130,22,38,174,135,154,60,151,7,153,187,127,39,107,76,122,114,82,101,27,30,134,58,86,181,150,23,12,54,142,121,168,3,98,78,110,81,52,106,118,183,83,26,79,185,148,167,61,59,36,46,5,41,133,96,157,138,45,188,87,66,126,198,21,50,53,51,29,158,156,160,71,69,190,43,128,85,164,111,88,40,37,145,139,33,13,172,195,25,109,141,35,6,56,92,194,31,171,152,57,186,113,196,89,162,146,28,74,4,97,131,0,199,62,44,34,108,20,55,155,184,161,80,137,177,169,191,11,104,180,163,170,95,91,90,125,149,32,68,63,100,116,175,165,193,16,136,144,70,19,64,103,112,84,77,115,179,176,42,47,132,166,119,48];191;False
2001;8379;10380;[174,159,93,182,1,117,2,129,135,14,99,73,140,178,192,10,123,17,8,94,173,18,102,120,24,197,15,9,150,143,67,189,49,65,124,147,130,22,38,105,72,154,60,151,7,153,187,127,39,107,76,122,114,75,101,27,30,134,58,86,181,82,23,12,54,142,121,168,3,98,78,110,81,52,106,118,183,83,26,79,185,148,167,61,59,36,46,5,41,133,96,157,138,45,188,87,66,126,198,21,50,53,51,29,158,156,160,71,69,190,43,128,85,164,111,88,40,37,145,139,33,13,172,195,25,109,141,35,6,56,92,194,31,171,152,57,186,113,196,89,162,146,28,74,4,97,131,0,199,62,44,34,108,20,55,155,184,161,80,137,177,169,191,11,104,180,163,170,95,91,90,125,149,32,68,63,100,116,175,165,193,16,136,144,70,19,64,103,112,84,77,115,179,176,42,47,132,166,119,48];192;False
2775;7160;9935;[194,8,12,22,26,118,176,3,2,130,84,117,77,112,193,109,66,157,103,105,20,188,93,87,6,149,167,61,45,138,41,49,78,128,42,57,37,121,162,126,143,160,91,1,33,124,94,196,36,182,92,178,147,23,189,81,0,85,104,31,74,140,9,144,170,95,38,139,19,46,51,50,34,198,146,123,82,67,32,72,163,25,70,65,16,190,11,113,156,71,165,184,174,191,173,18,131,110,101,59,80,100,30,134,148,195,97,58,175,151,7,172,181,68,180,142,137,158,54,52,119,187,39,107,55,14,13,111,132,89,75,4,15,135,53,183,69,159,164,90,28,155,73,99,106,136,115,152,35,161,102,86,133,76,122,116,44,125,145,56,21,108,192,40,169,129,29,154,60,177,27,43,127,96,171,141,98,114,64,79,179,47,88,5,186,199,83,153,166,24,150,10,185,62,120,197,168,17,48,63];193;False
2008;8346;10354;[198,14,159,182,1,117,2,129,135,105,99,73,140,178,192,10,123,17,8,94,173,18,75,120,24,197,15,9,93,143,67,189,49,65,156,147,130,22,38,174,72,154,60,151,7,153,187,127,39,107,76,122,114,82,101,27,30,134,58,86,181,150,23,12,54,142,121,168,3,98,78,110,81,52,106,118,124,83,26,79,185,148,167,61,59,36,46,5,41,133,96,157,138,45,188,87,66,126,20,21,50,53,51,29,158,102,160,71,69,190,43,128,85,164,111,88,40,37,145,139,33,13,172,195,25,109,141,35,6,56,92,194,31,171,152,57,186,113,196,89,162,146,28,74,4,97,131,0,199,62,44,34,108,183,55,155,184,161,80,137,177,169,191,11,104,180,163,170,95,91,90,125,149,32,68,63,100,116,175,165,193,16,136,144,70,19,64,103,112,84,77,115,179,176,42,47,132,166,119,48];194;False
1907;8425;10332;[107,105,75,182,1,117,2,129,72,14,99,73,140,178,192,10,123,17,8,94,173,18,102,120,24,197,15,9,93,143,67,189,49,65,124,147,130,22,38,174,135,154,60,151,7,153,187,127,39,159,76,122,114,82,101,27,30,134,58,86,181,150,23,12,54,142,121,168,3,98,78,110,81,52,106,118,183,83,26,79,185,148,167,61,59,36,46,5,41,133,96,157,138,45,188,87,66,126,198,21,50,53,51,29,158,156,160,71,69,190,43,128,85,164,111,88,40,37,145,139,33,13,172,195,25,109,141,35,6,56,92,194,31,171,152,57,186,113,196,89,162,146,28,74,4,97,131,0,199,62,44,34,108,20,55,155,184,161,80,137,177,169,191,11,104,180,163,170,95,91,90,125,149,32,68,63,100,116,175,165,193,16,136,144,70,19,64,103,112,84,77,115,179,176,42,47,132,166,119,48];195;False
1980;8373;10353;[106,159,93,182,1,117,2,129,135,14,99,73,140,178,192,10,123,17,8,94,173,18,102,120,24,197,15,9,150,143,67,189,49,65,124,147,130,22,38,105,72,154,60,151,7,153,187,127,39,107,76,122,114,75,101,27,30,134,58,86,181,82,23,12,54,142,121,168,3,98,78,110,81,52,174,118,183,83,26,79,185,148,167,61,59,36,46,5,41,133,96,157,138,45,188,87,66,126,198,21,50,53,51,29,158,156,160,71,69,190,43,128,85,164,111,88,40,37,145,139,33,13,172,195,25,109,141,35,6,56,92,194,31,171,152,57,186,113,196,89,162,146,28,74,4,97,131,0,199,62,44,34,108,20,55,155,184,161,80,137,177,169,191,11,104,180,163,170,95,91,90,125,149,32,68,63,100,116,175,165,193,16,136,144,70,19,64,103,112,84,77,115,179,176,42,47,132,166,119,48];196;False
2891;7158;10049;[20,8,12,22,26,118,176,3,2,130,84,117,77,112,193,109,66,157,103,105,194,188,93,87,6,149,167,61,45,138,41,49,78,128,42,57,37,121,162,126,143,160,91,1,33,124,94,196,36,182,92,178,147,23,189,81,0,85,104,31,74,140,9,144,170,95,38,139,19,46,51,50,34,198,146,123,82,67,32,72,163,25,70,65,16,190,11,113,156,71,165,184,174,191,173,18,131,110,101,59,80,100,30,134,148,195,97,58,175,151,7,172,181,68,180,142,137,158,54,52,119,187,39,107,55,14,13,111,132,89,75,4,15,135,53,183,69,159,164,90,28,155,73,99,106,136,115,152,35,161,102,86,133,76,122,116,44,125,145,56,21,108,192,40,169,129,29,154,60,177,27,43,127,96,171,141,98,114,64,79,179,47,88,5,186,199,83,153,166,24,150,10,185,62,120,197,168,17,48,63];197;False
2059;8342;10401;[162,14,159,182,1,117,2,129,135,105,99,73,140,178,192,10,123,17,8,94,173,18,75,120,24,197,15,9,93,143,67,189,49,65,156,147,130,22,38,174,72,154,60,151,7,153,187,127,39,107,76,122,114,82,101,27,30,134,58,86,181,150,23,12,54,142,121,168,3,98,78,110,81,52,106,118,124,83,26,79,185,148,167,61,59,36,46,5,41,133,96,157,138,45,188,87,66,126,20,21,50,53,51,29,158,102,160,71,69,190,43,128,85,164,111,88,40,37,145,139,33,13,172,195,25,109,141,35,6,56,92,194,31,171,152,57,186,113,196,89,198,146,28,74,4,97,131,0,199,62,44,34,108,183,55,155,184,161,80,137,177,169,191,11,104,180,163,170,95,91,90,125,149,32,68,63,100,116,175,165,193,16,136,144,70,19,64,103,112,84,77,115,179,176,42,47,132,166,119,48];198;False
1895;8434;10329;[150,105,75,182,1,117,2,129,72,14,99,73,140,178,192,10,123,17,8,94,173,18,102,120,24,197,15,9,93,143,67,189,49,65,124,147,130,22,38,174,135,154,60,151,7,153,187,127,39,159,76,122,114,82,101,27,30,134,58,86,181,107,23,12,54,142,121,168,3,98,78,110,81,52,106,118,183,83,26,79,185,148,167,61,59,36,46,5,41,133,96,157,138,45,188,87,66,126,198,21,50,53,51,29,158,156,160,71,69,190,43,128,85,164,111,88,40,37,145,139,33,13,172,195,25,109,141,35,6,56,92,194,31,171,152,57,186,113,196,89,162,146,28,74,4,97,131,0,199,62,44,34,108,20,55,155,184,161,80,137,177,169,191,11,104,180,163,170,95,91,90,125,149,32,68,63,100,116,175,165,193,16,136,144,70,19,64,103,112,84,77,115,179,176,42,47,132,166,119,48];199;False
1912;8367;10279;[198,159,93,182,1,117,2,129,135,14,99,73,140,178,192,10,123,17,8,94,173,18,102,120,24,197,15,9,150,143,67,189,49,65,124,147,130,22,38,105,72,154,60,151,7,153,187,127,39,107,76,122,114,75,101,27,30,134,58,86,181,82,23,12,54,142,121,168,3,98,78,110,81,52,174,118,183,83,26,79,185,148,167,61,59,36,46,5,41,133,96,157,138,45,188,87,66,126,106,21,50,53,51,29,158,156,160,71,69,190,43,128,85,164,111,88,40,37,145,139,33,13,172,195,25,109,141,35,6,56,92,194,31,171,152,57,186,113,196,89,162,146,28,74,4,97,131,0,199,62,44,34,108,20,55,155,184,161,80,137,177,169,191,11,104,180,163,170,95,91,90,125,149,32,68,63,100,116,175,165,193,16,136,144,70,19,64,103,112,84,77,115,179,176,42,47,132,166,119,48];200;False
2848;7158;10006;[20,188,12,22,26,118,176,3,2,130,84,117,77,112,193,109,66,157,103,105,194,8,93,87,6,149,167,61,45,138,41,49,78,128,42,57,37,121,162,126,143,160,91,1,33,124,94,196,36,182,92,178,147,23,189,81,0,85,104,31,74,140,9,144,170,95,38,139,19,46,51,50,34,198,146,123,82,67,32,72,163,25,70,65,16,190,11,113,156,71,165,184,174,191,173,18,131,110,101,59,80,100,30,134,148,195,97,58,175,151,7,172,181,68,180,142,137,158,54,52,119,187,39,107,55,14,13,111,132,89,75,4,15,135,53,183,69,159,164,90,28,155,73,99,106,136,115,152,35,161,102,86,133,76,122,116,44,125,145,56,21,108,192,40,169,129,29,154,60,177,27,43,127,96,171,141,98,114,64,79,179,47,88,5,186,199,83,153,166,24,150,10,185,62,120,197,168,17,48,63];201;False
1998;8339;10337;[135,14,159,182,1,117,2,129,162,105,99,73,140,178,192,10,123,17,8,94,173,18,75,120,24,197,15,9,93,143,67,189,49,65,156,147,130,22,38,174,72,154,60,151,7,153,187,127,39,107,76,122,114,82,101,27,30,134,58,86,181,150,23,12,54,142,121,168,3,98,78,110,81,52,106,118,124,83,26,79,185,148,167,61,59,36,46,5,41,133,96,157,138,45,188,87,66,126,20,21,50,53,51,29,158,102,160,71,69,190,43,128,85,164,111,88,40,37,145,139,33,13,172,195,25,109,141,35,6,56,92,194,31,171,152,57,186,113,196,89,198,146,28,74,4,97,131,0,199,62,44,34,108,183,55,155,184,161,80,137,177,169,191,11,104,180,163,170,95,91,90,125,149,32,68,63,100,116,175,165,193,16,136,144,70,19,64,103,112,84,77,115,179,176,42,47,132,166,119,48];202;False
1887;8427;10314;[150,105,161,182,1,117,2,129,72,14,99,73,140,178,192,10,123,17,8,94,173,18,102,120,24,197,15,9,93,143,67,189,49,65,124,147,130,22,38,174,135,154,60,151,7,153,187,127,39,159,76,122,114,82,101,27,30,134,58,86,181,107,23,12,54,142,121,168,3,98,78,110,81,52,106,118,183,83,26,79,185,148,167,61,59,36,46,5,41,133,96,157,138,45,188,87,66,126,198,21,50,53,51,29,158,156,160,71,69,190,43,128,85,164,111,88,40,37,145,139,33,13,172,195,25,109,141,35,6,56,92,194,31,171,152,57,186,113,196,89,162,146,28,74,4,97,131,0,199,62,44,34,108,20,55,155,184,75,80,137,177,169,191,11,104,180,163,170,95,91,90,125,149,32,68,63,100,116,175,165,193,16,136,144,70,19,64,103,112,84,77,115,179,176,42,47,132,166,119,48];203;False
1966;8364;10330;[158,159,93,182,1,117,2,129,135,14,99,73,140,178,192,10,123,17,8,94,173,18,102,120,24,197,15,9,150,143,67,189,49,65,124,147,130,22,38,105,72,154,60,151,7,153,187,127,39,107,76,122,114,75,101,27,30,134,58,86,181,82,23,12,54,142,121,168,3,98,78,110,81,52,174,118,183,83,26,79,185,148,167,61,59,36,46,5,41,133,96,157,138,45,188,87,66,126,106,21,50,53,51,29,198,156,160,71,69,190,43,128,85,164,111,88,40,37,145,139,33,13,172,195,25,109,141,35,6,56,92,194,31,171,152,57,186,113,196,89,162,146,28,74,4,97,131,0,199,62,44,34,108,20,55,155,184,161,80,137,177,169,191,11,104,180,163,170,95,91,90,125,149,32,68,63,100,116,175,165,193,16,136,144,70,19,64,103,112,84,77,115,179,176,42,47,132,166,119,48];204;False
3002;7154;10156;[194,188,12,22,26,118,176,3,2,130,84,117,77,112,193,109,66,157,103,105,20,8,93,87,6,149,167,61,45,138,41,49,78,128,42,57,37,121,162,126,143,160,91,1,33,124,94,196,36,182,92,178,147,23,189,81,0,85,104,31,74,140,9,144,170,95,38,139,19,46,51,50,34,198,146,123,82,67,32,72,163,25,70,65,16,190,11,113,156,71,165,184,174,191,173,18,131,110,101,59,80,100,30,134,148,195,97,58,175,151,7,172,181,68,180,142,137,158,54,52,119,187,39,107,55,14,13,111,132,89,75,4,15,135,53,183,69,159,164,90,28,155,73,99,106,136,115,152,35,161,102,86,133,76,122,116,44,125,145,56,21,108,192,40,169,129,29,154,60,177,27,43,127,96,171,141,98,114,64,79,179,47,88,5,186,199,83,153,166,24,150,10,185,62,120,197,168,17,48,63];205;False
2002;8333;10335;[105,14,159,182,1,117,2,129,162,135,99,73,140,178,192,10,123,17,8,94,173,18,75,120,24,197,15,9,93,143,67,189,49,65,156,147,130,22,38,174,72,154,60,151,7,153,187,127,39,107,76,122,114,82,101,27,30,134,58,86,181,150,23,12,54,142,121,168,3,98,78,110,81,52,106,118,124,83,26,79,185,148,167,61,59,36,46,5,41,133,96,157,138,45,188,87,66,126,20,21,50,53,51,29,158,102,160,71,69,190,43,128,85,164,111,88,40,37,145,139,33,13,172,195,25,109,141,35,6,56,92,194,31,171,152,57,186,113,196,89,198,146,28,74,4,97,131,0,199,62,44,34,108,183,55,155,184,161,80,137,177,169,191,11,104,180,163,170,95,91,90,125,149,32,68,63,100,116,175,165,193,16,136,144,70,19,64,103,112,84,77,115,179,176,42,47,132,166,119,48];206;False
1908;8420;10328;[93,105,161,182,1,117,2,129,72,14,99,73,140,178,192,10,123,17,8,94,173,18,102,120,24,197,15,9,150,143,67,189,49,65,124,147,130,22,38,174,135,154,60,151,7,153,187,127,39,159,76,122,114,82,101,27,30,134,58,86,181,107,23,12,54,142,121,168,3,98,78,110,81,52,106,118,183,83,26,79,185,148,167,61,59,36,46,5,41,133,96,157,138,45,188,87,66,126,198,21,50,53,51,29,158,156,160,71,69,190,43,128,85,164,111,88,40,37,145,139,33,13,172,195,25,109,141,35,6,56,92,194,31,171,152,57,186,113,196,89,162,146,28,74,4,97,131,0,199,62,44,34,108,20,55,155,184,75,80,137,177,169,191,11,104,180,163,170,95,91,90,125,149,32,68,63,100,116,175,165,193,16,136,144,70,19,64,103,112,84,77,115,179,176,42,47,132,166,119,48];207;False
1948;8356;10304;[159,158,93,182,1,117,2,129,135,14,99,73,140,178,192,10,123,17,8,94,173,18,102,120,24,197,15,9,150,143,67,189,49,65,124,147,130,22,38,105,72,154,60,151,7,153,187,127,39,107,76,122,114,75,101,27,30,134,58,86,181,82,23,12,54,142,121,168,3,98,78,110,81,52,174,118,183,83,26,79,185,148,167,61,59,36,46,5,41,133,96,157,138,45,188,87,66,126,106,21,50,53,51,29,198,156,160,71,69,190,43,128,85,164,111,88,40,37,145,139,33,13,172,195,25,109,141,35,6,56,92,194,31,171,152,57,186,113,196,89,162,146,28,74,4,97,131,0,199,62,44,34,108,20,55,155,184,161,80,137,177,169,191,11,104,180,163,170,95,91,90,125,149,32,68,63,100,116,175,165,193,16,136,144,70,19,64,103,112,84,77,115,179,176,42,47,132,166,119,48];208;False
2981;7157;10138;[74,188,12,22,26,118,176,3,2,130,84,117,77,112,193,109,66,157,103,105,20,8,93,87,6,149,167,61,45,138,41,49,78,128,42,57,37,121,162,126,143,160,91,1,33,124,94,196,36,182,92,178,147,23,189,81,0,85,104,31,194,140,9,144,170,95,38,139,19,46,51,50,34,198,146,123,82,67,32,72,163,25,70,65,16,190,11,113,156,71,165,184,174,191,173,18,131,110,101,59,80,100,30,134,148,195,97,58,175,151,7,172,181,68,180,142,137,158,54,52,119,187,39,107,55,14,13,111,132,89,75,4,15,135,53,183,69,159,164,90,28,155,73,99,106,136,115,152,35,161,102,86,133,76,122,116,44,125,145,56,21,108,192,40,169,129,29,154,60,177,27,43,127,96,171,141,98,114,64,79,179,47,88,5,186,199,83,153,166,24,150,10,185,62,120,197,168,17,48,63];209;False
2076;8305;10381;[174,14,159,182,1,117,2,129,162,135,99,73,140,178,192,10,123,17,8,94,173,18,75,120,24,197,15,9,93,143,67,189,49,65,156,147,130,22,38,105,72,154,60,151,7,153,187,127,39,107,76,122,114,82,101,27,30,134,58,86,181,150,23,12,54,142,121,168,3,98,78,110,81,52,106,118,124,83,26,79,185,148,167,61,59,36,46,5,41,133,96,157,138,45,188,87,66,126,20,21,50,53,51,29,158,102,160,71,69,190,43,128,85,164,111,88,40,37,145,139,33,13,172,195,25,109,141,35,6,56,92,194,31,171,152,57,186,113,196,89,198,146,28,74,4,97,131,0,199,62,44,34,108,183,55,155,184,161,80,137,177,169,191,11,104,180,163,170,95,91,90,125,149,32,68,63,100,116,175,165,193,16,136,144,70,19,64,103,112,84,77,115,179,176,42,47,132,166,119,48];210;False
1898;8404;10302;[103,105,161,182,1,117,2,129,72,14,99,73,140,178,192,10,123,17,8,94,173,18,102,120,24,197,15,9,150,143,67,189,49,65,124,147,130,22,38,174,135,154,60,151,7,153,187,127,39,159,76,122,114,82,101,27,30,134,58,86,181,107,23,12,54,142,121,168,3,98,78,110,81,52,106,118,183,83,26,79,185,148,167,61,59,36,46,5,41,133,96,157,138,45,188,87,66,126,198,21,50,53,51,29,158,156,160,71,69,190,43,128,85,164,111,88,40,37,145,139,33,13,172,195,25,109,141,35,6,56,92,194,31,171,152,57,186,113,196,89,162,146,28,74,4,97,131,0,199,62,44,34,108,20,55,155,184,75,80,137,177,169,191,11,104,180,163,170,95,91,90,125,149,32,68,63,100,116,175,165,193,16,136,144,70,19,64,93,112,84,77,115,179,176,42,47,132,166,119,48];211;False
1977;8344;10321;[102,158,93,182,1,117,2,129,135,14,99,73,140,178,192,10,123,17,8,94,173,18,159,120,24,197,15,9,150,143,67,189,49,65,124,147,130,22,38,105,72,154,60,151,7,153,187,127,39,107,76,122,114,75,101,27,30,134,58,86,181,82,23,12,54,142,121,168,3,98,78,110,81,52,174,118,183,83,26,79,185,148,167,61,59,36,46,5,41,133,96,157,138,45,188,87,66,126,106,21,50,53,51,29,198,156,160,71,69,190,43,128,85,164,111,88,40,37,145,139,33,13,172,195,25,109,141,35,6,56,92,194,31,171,152,57,186,113,196,89,162,146,28,74,4,97,131,0,199,62,44,34,108,20,55,155,184,161,80,137,177,169,191,11,104,180,163,170,95,91,90,125,149,32,68,63,100,116,175,165,193,16,136,144,70,19,64,103,112,84,77,115,179,176,42,47,132,166,119,48];212;False
2897;7152;10049;[20,188,12,22,26,118,176,3,2,130,84,117,77,112,193,109,66,157,103,105,74,8,93,87,6,149,167,61,45,138,41,49,78,128,42,57,37,121,162,126,143,160,91,1,33,124,94,196,36,182,92,178,147,23,189,81,0,85,104,31,194,140,9,144,170,95,38,139,19,46,51,50,34,198,146,123,82,67,32,72,163,25,70,65,16,190,11,113,156,71,165,184,174,191,173,18,131,110,101,59,80,100,30,134,148,195,97,58,175,151,7,172,181,68,180,142,137,158,54,52,119,187,39,107,55,14,13,111,132,89,75,4,15,135,53,183,69,159,164,90,28,155,73,99,106,136,115,152,35,161,102,86,133,76,122,116,44,125,145,56,21,108,192,40,169,129,29,154,60,177,27,43,127,96,171,141,98,114,64,79,179,47,88,5,186,199,83,153,166,24,150,10,185,62,120,197,168,17,48,63];213;False
2085;8303;10388;[140,14,159,182,1,117,2,129,162,135,99,73,174,178,192,10,123,17,8,94,173,18,75,120,24,197,15,9,93,143,67,189,49,65,156,147,130,22,38,105,72,154,60,151,7,153,187,127,39,107,76,122,114,82,101,27,30,134,58,86,181,150,23,12,54,142,121,168,3,98,78,110,81,52,106,118,124,83,26,79,185,148,167,61,59,36,46,5,41,133,96,157,138,45,188,87,66,126,20,21,50,53,51,29,158,102,160,71,69,190,43,128,85,164,111,88,40,37,145,139,33,13,172,195,25,109,141,35,6,56,92,194,31,171,152,57,186,113,196,89,198,146,28,74,4,97,131,0,199,62,44,34,108,183,55,155,184,161,80,137,177,169,191,11,104,180,163,170,95,91,90,125,149,32,68,63,100,116,175,165,193,16,136,144,70,19,64,103,112,84,77,115,179,176,42,47,132,166,119,48];214;False
1908;8391;10299;[103,105,158,182,1,117,2,129,72,14,99,73,140,178,192,10,123,17,8,94,173,18,102,120,24,197,15,9,150,143,67,189,49,65,124,147,130,22,38,174,135,154,60,151,7,153,187,127,39,159,76,122,114,82,101,27,30,134,58,86,181,107,23,12,54,142,121,168,3,98,78,110,81,52,106,118,183,83,26,79,185,148,167,61,59,36,46,5,41,133,96,157,138,45,188,87,66,126,198,21,50,53,51,29,161,156,160,71,69,190,43,128,85,164,111,88,40,37,145,139,33,13,172,195,25,109,141,35,6,56,92,194,31,171,152,57,186,113,196,89,162,146,28,74,4,97,131,0,199,62,44,34,108,20,55,155,184,75,80,137,177,169,191,11,104,180,163,170,95,91,90,125,149,32,68,63,100,116,175,165,193,16,136,144,70,19,64,93,112,84,77,115,179,176,42,47,132,166,119,48];215;False
1964;8350;10314;[58,158,93,182,1,117,2,129,135,14,99,73,140,178,192,10,123,17,8,94,173,18,159,120,24,197,15,9,150,143,67,189,49,65,124,147,130,22,38,105,72,154,60,151,7,153,187,127,39,107,76,122,114,75,101,27,30,134,102,86,181,82,23,12,54,142,121,168,3,98,78,110,81,52,174,118,183,83,26,79,185,148,167,61,59,36,46,5,41,133,96,157,138,45,188,87,66,126,106,21,50,53,51,29,198,156,160,71,69,190,43,128,85,164,111,88,40,37,145,139,33,13,172,195,25,109,141,35,6,56,92,194,31,171,152,57,186,113,196,89,162,146,28,74,4,97,131,0,199,62,44,34,108,20,55,155,184,161,80,137,177,169,191,11,104,180,163,170,95,91,90,125,149,32,68,63,100,116,175,165,193,16,136,144,70,19,64,103,112,84,77,115,179,176,42,47,132,166,119,48];216;False
3042;7148;10190;[20,103,12,22,26,118,176,3,2,130,84,117,77,112,193,109,66,157,188,105,74,8,93,87,6,149,167,61,45,138,41,49,78,128,42,57,37,121,162,126,143,160,91,1,33,124,94,196,36,182,92,178,147,23,189,81,0,85,104,31,194,140,9,144,170,95,38,139,19,46,51,50,34,198,146,123,82,67,32,72,163,25,70,65,16,190,11,113,156,71,165,184,174,191,173,18,131,110,101,59,80,100,30,134,148,195,97,58,175,151,7,172,181,68,180,142,137,158,54,52,119,187,39,107,55,14,13,111,132,89,75,4,15,135,53,183,69,159,164,90,28,155,73,99,106,136,115,152,35,161,102,86,133,76,122,116,44,125,145,56,21,108,192,40,169,129,29,154,60,177,27,43,127,96,171,141,98,114,64,79,179,47,88,5,186,199,83,153,166,24,150,10,185,62,120,197,168,17,48,63];217;False
2064;8327;10391;[118,14,159,182,1,117,2,129,162,135,99,73,174,178,192,10,123,17,8,94,173,18,75,120,24,197,15,9,93,143,67,189,49,65,156,147,130,22,38,105,72,154,60,151,7,153,187,127,39,107,76,122,114,82,101,27,30,134,58,86,181,150,23,12,54,142,121,168,3,98,78,110,81,52,106,140,124,83,26,79,185,148,167,61,59,36,46,5,41,133,96,157,138,45,188,87,66,126,20,21,50,53,51,29,158,102,160,71,69,190,43,128,85,164,111,88,40,37,145,139,33,13,172,195,25,109,141,35,6,56,92,194,31,171,152,57,186,113,196,89,198,146,28,74,4,97,131,0,199,62,44,34,108,183,55,155,184,161,80,137,177,169,191,11,104,180,163,170,95,91,90,125,149,32,68,63,100,116,175,165,193,16,136,144,70,19,64,103,112,84,77,115,179,176,42,47,132,166,119,48];218;False
1894;8420;10314;[103,105,117,182,1,158,2,129,72,14,99,73,140,178,192,10,123,17,8,94,173,18,102,120,24,197,15,9,150,143,67,189,49,65,124,147,130,22,38,174,135,154,60,151,7,153,187,127,39,159,76,122,114,82,101,27,30,134,58,86,181,107,23,12,54,142,121,168,3,98,78,110,81,52,106,118,183,83,26,79,185,148,167,61,59,36,46,5,41,133,96,157,138,45,188,87,66,126,198,21,50,53,51,29,161,156,160,71,69,190,43,128,85,164,111,88,40,37,145,139,33,13,172,195,25,109,141,35,6,56,92,194,31,171,152,57,186,113,196,89,162,146,28,74,4,97,131,0,199,62,44,34,108,20,55,155,184,75,80,137,177,169,191,11,104,180,163,170,95,91,90,125,149,32,68,63,100,116,175,165,193,16,136,144,70,19,64,93,112,84,77,115,179,176,42,47,132,166,119,48];219;False
1981;8332;10313;[137,158,93,182,1,117,2,129,135,14,99,73,140,178,192,10,123,17,8,94,173,18,159,120,24,197,15,9,150,143,67,189,49,65,124,147,130,22,38,105,72,154,60,151,7,153,187,127,39,107,76,122,114,75,101,27,30,134,102,86,181,82,23,12,54,142,121,168,3,98,78,110,81,52,174,118,183,83,26,79,185,148,167,61,59,36,46,5,41,133,96,157,138,45,188,87,66,126,106,21,50,53,51,29,198,156,160,71,69,190,43,128,85,164,111,88,40,37,145,139,33,13,172,195,25,109,141,35,6,56,92,194,31,171,152,57,186,113,196,89,162,146,28,74,4,97,131,0,199,62,44,34,108,20,55,155,184,161,80,58,177,169,191,11,104,180,163,170,95,91,90,125,149,32,68,63,100,116,175,165,193,16,136,144,70,19,64,103,112,84,77,115,179,176,42,47,132,166,119,48];220;False
3040;7151;10191;[194,103,12,22,26,118,176,3,2,130,84,117,77,112,193,109,66,157,188,105,74,8,93,87,6,149,167,61,45,138,41,49,78,128,42,57,37,121,162,126,143,160,91,1,33,124,94,196,36,182,92,178,147,23,189,81,0,85,104,31,20,140,9,144,170,95,38,139,19,46,51,50,34,198,146,123,82,67,32,72,163,25,70,65,16,190,11,113,156,71,165,184,174,191,173,18,131,110,101,59,80,100,30,134,148,195,97,58,175,151,7,172,181,68,180,142,137,158,54,52,119,187,39,107,55,14,13,111,132,89,75,4,15,135,53,183,69,159,164,90,28,155,73,99,106,136,115,152,35,161,102,86,133,76,122,116,44,125,145,56,21,108,192,40,169,129,29,154,60,177,27,43,127,96,171,141,98,114,64,79,179,47,88,5,186,199,83,153,166,24,150,10,185,62,120,197,168,17,48,63];221;False
2010;8324;10334;[118,160,159,182,1,117,2,129,162,135,99,73,174,178,192,10,123,17,8,94,173,18,75,120,24,197,15,9,93,143,67,189,49,65,156,147,130,22,38,105,72,154,60,151,7,153,187,127,39,107,76,122,114,82,101,27,30,134,58,86,181,150,23,12,54,142,121,168,3,98,78,110,81,52,106,140,124,83,26,79,185,148,167,61,59,36,46,5,41,133,96,157,138,45,188,87,66,126,20,21,50,53,51,29,158,102,14,71,69,190,43,128,85,164,111,88,40,37,145,139,33,13,172,195,25,109,141,35,6,56,92,194,31,171,152,57,186,113,196,89,198,146,28,74,4,97,131,0,199,62,44,34,108,183,55,155,184,161,80,137,177,169,191,11,104,180,163,170,95,91,90,125,149,32,68,63,100,116,175,165,193,16,136,144,70,19,64,103,112,84,77,115,179,176,42,47,132,166,119,48];222;False
1857;8408;10265;[103,105,117,182,1,152,2,129,72,14,99,73,140,178,192,10,123,17,8,94,173,18,102,120,24,197,15,9,150,143,67,189,49,65,124,147,130,22,38,174,135,154,60,151,7,153,187,127,39,159,76,122,114,82,101,27,30,134,58,86,181,107,23,12,54,142,121,168,3,98,78,110,81,52,106,118,183,83,26,79,185,148,167,61,59,36,46,5,41,133,96,157,138,45,188,87,66,126,198,21,50,53,51,29,161,156,160,71,69,190,43,128,85,164,111,88,40,37,145,139,33,13,172,195,25,109,141,35,6,56,92,194,31,171,158,57,186,113,196,89,162,146,28,74,4,97,131,0,199,62,44,34,108,20,55,155,184,75,80,137,177,169,191,11,104,180,163,170,95,91,90,125,149,32,68,63,100,116,175,165,193,16,136,144,70,19,64,93,112,84,77,115,179,176,42,47,132,166,119,48];223;False
1982;8313;10295;[102,158,93,182,1,117,2,129,135,14,99,73,140,178,192,10,123,17,8,94,173,18,159,120,24,197,15,9,150,143,67,189,49,65,124,147,130,22,38,105,72,154,60,151,7,153,187,127,39,107,76,122,114,75,101,27,30,134,137,86,181,82,23,12,54,142,121,168,3,98,78,110,81,52,174,118,183,83,26,79,185,148,167,61,59,36,46,5,41,133,96,157,138,45,188,87,66,126,106,21,50,53,51,29,198,156,160,71,69,190,43,128,85,164,111,88,40,37,145,139,33,13,172,195,25,109,141,35,6,56,92,194,31,171,152,57,186,113,196,89,162,146,28,74,4,97,131,0,199,62,44,34,108,20,55,155,184,161,80,58,177,169,191,11,104,180,163,170,95,91,90,125,149,32,68,63,100,116,175,165,193,16,136,144,70,19,64,103,112,84,77,115,179,176,42,47,132,166,119,48];224;False
2978;7151;10129;[194,172,12,22,26,118,176,3,2,130,84,117,77,112,193,109,66,157,188,105,74,8,93,87,6,149,167,61,45,138,41,49,78,128,42,57,37,121,162,126,143,160,91,1,33,124,94,196,36,182,92,178,147,23,189,81,0,85,104,31,20,140,9,144,170,95,38,139,19,46,51,50,34,198,146,123,82,67,32,72,163,25,70,65,16,190,11,113,156,71,165,184,174,191,173,18,131,110,101,59,80,100,30,134,148,195,97,58,175,151,7,103,181,68,180,142,137,158,54,52,119,187,39,107,55,14,13,111,132,89,75,4,15,135,53,183,69,159,164,90,28,155,73,99,106,136,115,152,35,161,102,86,133,76,122,116,44,125,145,56,21,108,192,40,169,129,29,154,60,177,27,43,127,96,171,141,98,114,64,79,179,47,88,5,186,199,83,153,166,24,150,10,185,62,120,197,168,17,48,63];225;False
1889;8375;10264;[103,105,152,182,1,117,2,129,72,14,99,73,140,178,192,10,123,17,8,94,173,18,102,120,24,197,15,9,150,143,67,189,49,65,124,147,130,22,38,174,135,154,60,151,7,153,187,127,39,159,76,122,114,82,101,27,30,134,58,86,181,107,23,12,54,142,121,168,3,98,78,110,81,52,106,118,183,83,26,79,185,148,167,61,59,36,46,5,41,133,96,157,138,45,188,87,66,126,198,21,50,53,51,29,161,156,160,71,69,190,43,128,85,164,111,88,40,37,145,139,33,13,172,195,25,109,141,35,6,56,92,194,31,171,158,57,186,113,196,89,162,146,28,74,4,97,131,0,199,62,44,34,108,20,55,155,184,75,80,137,177,169,191,11,104,180,163,170,95,91,90,125,149,32,68,63,100,116,175,165,193,16,136,144,70,19,64,93,112,84,77,115,179,176,42,47,132,166,119,48];226;False
1953;8325;10278;[159,158,93,182,1,117,2,129,135,14,99,73,140,178,192,10,123,17,8,94,173,18,102,120,24,197,15,9,150,143,67,189,49,65,124,147,130,22,38,105,72,154,60,151,7,153,187,127,39,107,76,122,114,75,101,27,30,134,137,86,181,82,23,12,54,142,121,168,3,98,78,110,81,52,174,118,183,83,26,79,185,148,167,61,59,36,46,5,41,133,96,157,138,45,188,87,66,126,106,21,50,53,51,29,198,156,160,71,69,190,43,128,85,164,111,88,40,37,145,139,33,13,172,195,25,109,141,35,6,56,92,194,31,171,152,57,186,113,196,89,162,146,28,74,4,97,131,0,199,62,44,34,108,20,55,155,184,161,80,58,177,169,191,11,104,180,163,170,95,91,90,125,149,32,68,63,100,116,175,165,193,16,136,144,70,19,64,103,112,84,77,115,179,176,42,47,132,166,119,48];227;False
3036;7145;10181;[194,102,12,22,26,118,176,3,2,130,84,117,77,112,193,109,66,157,188,105,74,8,93,87,6,149,167,61,45,138,41,49,78,128,42,57,37,121,162,126,143,160,91,1,33,124,94,196,36,182,92,178,147,23,189,81,0,85,104,31,20,140,9,144,170,95,38,139,19,46,51,50,34,198,146,123,82,67,32,72,163,25,70,65,16,190,11,113,156,71,165,184,174,191,173,18,131,110,101,59,80,100,30,134,148,195,97,58,175,151,7,103,181,68,180,142,137,158,54,52,119,187,39,107,55,14,13,111,132,89,75,4,15,135,53,183,69,159,164,90,28,155,73,99,106,136,115,152,35,161,172,86,133,76,122,116,44,125,145,56,21,108,192,40,169,129,29,154,60,177,27,43,127,96,171,141,98,114,64,79,179,47,88,5,186,199,83,153,166,24,150,10,185,62,120,197,168,17,48,63];228;False
1888;8375;10263;[103,105,115,182,1,117,2,129,72,14,99,73,140,178,192,10,123,17,8,94,173,18,102,120,24,197,15,9,150,143,67,189,49,65,124,147,130,22,38,174,135,154,60,151,7,153,187,127,39,159,76,122,114,82,101,27,30,134,58,86,181,107,23,12,54,142,121,168,3,98,78,110,81,52,106,118,183,83,26,79,185,148,167,61,59,36,46,5,41,133,96,157,138,45,188,87,66,126,198,21,50,53,51,29,161,156,160,71,69,190,43,128,85,164,111,88,40,37,145,139,33,13,172,195,25,109,141,35,6,56,92,194,31,171,158,57,186,113,196,89,162,146,28,74,4,97,131,0,199,62,44,34,108,20,55,155,184,75,80,137,177,169,191,11,104,180,163,170,95,91,90,125,149,32,68,63,100,116,175,165,193,16,136,144,70,19,64,93,112,84,77,152,179,176,42,47,132,166,119,48];229;False
2052;8311;10363;[78,158,93,182,1,117,2,129,135,14,99,73,140,178,192,10,123,17,8,94,173,18,102,120,24,197,15,9,150,143,67,189,49,65,124,147,130,22,38,105,72,154,60,151,7,153,187,127,39,107,76,122,114,75,101,27,30,134,137,86,181,82,23,12,54,142,121,168,3,98,159,110,81,52,174,118,183,83,26,79,185,148,167,61,59,36,46,5,41,133,96,157,138,45,188,87,66,126,106,21,50,53,51,29,198,156,160,71,69,190,43,128,85,164,111,88,40,37,145,139,33,13,172,195,25,109,141,35,6,56,92,194,31,171,152,57,186,113,196,89,162,146,28,74,4,97,131,0,199,62,44,34,108,20,55,155,184,161,80,58,177,169,191,11,104,180,163,170,95,91,90,125,149,32,68,63,100,116,175,165,193,16,136,144,70,19,64,103,112,84,77,115,179,176,42,47,132,166,119,48];230;False
3015;7146;10161;[194,103,12,22,26,118,176,3,2,130,84,117,77,112,193,109,66,157,188,105,74,8,93,87,6,149,167,61,45,138,41,49,78,128,42,57,37,121,162,126,143,160,91,1,33,124,94,196,36,182,92,178,147,23,189,81,0,85,104,31,20,140,9,144,170,95,38,139,19,46,51,50,34,198,146,123,82,67,32,72,163,25,70,65,16,190,11,113,156,71,165,184,174,191,173,18,131,110,101,59,80,100,30,134,148,195,97,58,175,151,7,102,181,68,180,142,137,158,54,52,119,187,39,107,55,14,13,111,132,89,75,4,15,135,53,183,69,159,164,90,28,155,73,99,106,136,115,152,35,161,172,86,133,76,122,116,44,125,145,56,21,108,192,40,169,129,29,154,60,177,27,43,127,96,171,141,98,114,64,79,179,47,88,5,186,199,83,153,166,24,150,10,185,62,120,197,168,17,48,63];231;False
1883;8377;10260;[103,105,159,182,1,117,2,129,72,14,99,73,140,178,192,10,123,17,8,94,173,18,102,120,24,197,15,9,150,143,67,189,49,65,124,147,130,22,38,174,135,154,60,151,7,153,187,127,39,115,76,122,114,82,101,27,30,134,58,86,181,107,23,12,54,142,121,168,3,98,78,110,81,52,106,118,183,83,26,79,185,148,167,61,59,36,46,5,41,133,96,157,138,45,188,87,66,126,198,21,50,53,51,29,161,156,160,71,69,190,43,128,85,164,111,88,40,37,145,139,33,13,172,195,25,109,141,35,6,56,92,194,31,171,158,57,186,113,196,89,162,146,28,74,4,97,131,0,199,62,44,34,108,20,55,155,184,75,80,137,177,169,191,11,104,180,163,170,95,91,90,125,149,32,68,63,100,116,175,165,193,16,136,144,70,19,64,93,112,84,77,152,179,176,42,47,132,166,119,48];232;False
2054;8270;10324;[78,159,93,182,1,117,2,129,135,14,99,73,140,178,192,10,123,17,8,94,173,18,102,120,24,197,15,9,150,143,67,189,49,65,124,147,130,22,38,105,72,154,60,151,7,153,187,127,39,107,76,122,114,75,101,27,30,134,137,86,181,82,23,12,54,142,121,168,3,98,158,110,81,52,174,118,183,83,26,79,185,148,167,61,59,36,46,5,41,133,96,157,138,45,188,87,66,126,106,21,50,53,51,29,198,156,160,71,69,190,43,128,85,164,111,88,40,37,145,139,33,13,172,195,25,109,141,35,6,56,92,194,31,171,152,57,186,113,196,89,162,146,28,74,4,97,131,0,199,62,44,34,108,20,55,155,184,161,80,58,177,169,191,11,104,180,163,170,95,91,90,125,149,32,68,63,100,116,175,165,193,16,136,144,70,19,64,103,112,84,77,115,179,176,42,47,132,166,119,48];233;False
3017;7143;10160;[20,103,12,22,26,118,176,3,2,130,84,117,77,112,193,109,66,157,188,105,74,8,93,87,6,149,167,61,45,138,41,49,78,128,42,57,37,121,162,126,143,160,91,1,33,124,94,196,36,182,92,178,147,23,189,81,0,85,104,31,194,140,9,144,170,95,38,139,19,46,51,50,34,198,146,123,82,67,32,72,163,25,70,65,16,190,11,113,156,71,165,184,174,191,173,18,131,110,101,59,80,100,30,134,148,195,97,58,175,151,7,102,181,68,180,142,137,158,54,52,119,187,39,107,55,14,13,111,132,89,75,4,15,135,53,183,69,159,164,90,28,155,73,99,106,136,115,152,35,161,172,86,133,76,122,116,44,125,145,56,21,108,192,40,169,129,29,154,60,177,27,43,127,96,171,141,98,114,64,79,179,47,88,5,186,199,83,153,166,24,150,10,185,62,120,197,168,17,48,63];234;False
1940;8360;10300;[103,74,159,182,1,117,2,129,72,14,99,73,140,178,192,10,123,17,8,94,173,18,102,120,24,197,15,9,150,143,67,189,49,65,124,147,130,22,38,174,135,154,60,151,7,153,187,127,39,115,76,122,114,82,101,27,30,134,58,86,181,107,23,12,54,142,121,168,3,98,78,110,81,52,106,118,183,83,26,79,185,148,167,61,59,36,46,5,41,133,96,157,138,45,188,87,66,126,198,21,50,53,51,29,161,156,160,71,69,190,43,128,85,164,111,88,40,37,145,139,33,13,172,195,25,109,141,35,6,56,92,194,31,171,158,57,186,113,196,89,162,146,28,105,4,97,131,0,199,62,44,34,108,20,55,155,184,75,80,137,177,169,191,11,104,180,163,170,95,91,90,125,149,32,68,63,100,116,175,165,193,16,136,144,70,19,64,93,112,84,77,152,179,176,42,47,132,166,119,48];235;False
2038;8307;10345;[159,78,93,182,1,117,2,129,135,14,99,73,140,178,192,10,123,17,8,94,173,18,102,120,24,197,15,9,150,143,67,189,49,65,124,147,130,22,38,105,72,154,60,151,7,153,187,127,39,107,76,122,114,75,101,27,30,134,137,86,181,82,23,12,54,142,121,168,3,98,158,110,81,52,174,118,183,83,26,79,185,148,167,61,59,36,46,5,41,133,96,157,138,45,188,87,66,126,106,21,50,53,51,29,198,156,160,71,69,190,43,128,85,164,111,88,40,37,145,139,33,13,172,195,25,109,141,35,6,56,92,194,31,171,152,57,186,113,196,89,162,146,28,74,4,97,131,0,199,62,44,34,108,20,55,155,184,161,80,58,177,169,191,11,104,180,163,170,95,91,90,125,149,32,68,63,100,116,175,165,193,16,136,144,70,19,64,103,112,84,77,115,179,176,42,47,132,166,119,48];236;False
2051;8282;10333;[198,159,93,182,1,117,2,129,135,14,99,73,140,178,192,10,123,17,8,94,173,18,102,120,24,197,15,9,150,143,67,189,49,65,124,147,130,22,38,105,72,154,60,151,7,153,187,127,39,107,76,122,114,75,101,27,30,134,137,86,181,82,23,12,54,142,121,168,3,98,158,110,81,52,174,118,183,83,26,79,185,148,167,61,59,36,46,5,41,133,96,157,138,45,188,87,66,126,106,21,50,53,51,29,78,156,160,71,69,190,43,128,85,164,111,88,40,37,145,139,33,13,172,195,25,109,141,35,6,56,92,194,31,171,152,57,186,113,196,89,162,146,28,74,4,97,131,0,199,62,44,34,108,20,55,155,184,161,80,58,177,169,191,11,104,180,163,170,95,91,90,125,149,32,68,63,100,116,175,165,193,16,136,144,70,19,64,103,112,84,77,115,179,176,42,47,132,166,119,48];237;False
2872;7147;10019;[20,188,12,22,26,118,176,3,2,130,84,117,77,112,193,109,66,157,103,105,74,8,93,87,6,149,167,61,45,138,41,49,78,128,42,57,37,121,162,126,143,160,91,1,33,124,94,196,36,182,92,178,147,23,189,81,0,85,104,31,194,140,9,144,170,95,38,139,19,46,51,50,34,198,146,123,82,67,32,72,163,25,70,65,16,190,11,113,156,71,165,184,174,191,173,18,131,110,101,59,80,100,30,134,148,195,97,58,175,151,7,102,181,68,180,142,137,158,54,52,119,187,39,107,55,14,13,111,132,89,75,4,15,135,53,183,69,159,164,90,28,155,73,99,106,136,115,152,35,161,172,86,133,76,122,116,44,125,145,56,21,108,192,40,169,129,29,154,60,177,27,43,127,96,171,141,98,114,64,79,179,47,88,5,186,199,83,153,166,24,150,10,185,62,120,197,168,17,48,63];238;False
1941;8332;10273;[73,74,159,182,1,117,2,129,72,14,99,103,140,178,192,10,123,17,8,94,173,18,102,120,24,197,15,9,150,143,67,189,49,65,124,147,130,22,38,174,135,154,60,151,7,153,187,127,39,115,76,122,114,82,101,27,30,134,58,86,181,107,23,12,54,142,121,168,3,98,78,110,81,52,106,118,183,83,26,79,185,148,167,61,59,36,46,5,41,133,96,157,138,45,188,87,66,126,198,21,50,53,51,29,161,156,160,71,69,190,43,128,85,164,111,88,40,37,145,139,33,13,172,195,25,109,141,35,6,56,92,194,31,171,158,57,186,113,196,89,162,146,28,105,4,97,131,0,199,62,44,34,108,20,55,155,184,75,80,137,177,169,191,11,104,180,163,170,95,91,90,125,149,32,68,63,100,116,175,165,193,16,136,144,70,19,64,93,112,84,77,152,179,176,42,47,132,166,119,48];239;False
2034;8307;10341;[88,78,93,182,1,117,2,129,135,14,99,73,140,178,192,10,123,17,8,94,173,18,102,120,24,197,15,9,150,143,67,189,49,65,124,147,130,22,38,105,72,154,60,151,7,153,187,127,39,107,76,122,114,75,101,27,30,134,137,86,181,82,23,12,54,142,121,168,3,98,158,110,81,52,174,118,183,83,26,79,185,148,167,61,59,36,46,5,41,133,96,157,138,45,188,87,66,126,106,21,50,53,51,29,198,156,160,71,69,190,43,128,85,164,111,159,40,37,145,139,33,13,172,195,25,109,141,35,6,56,92,194,31,171,152,57,186,113,196,89,162,146,28,74,4,97,131,0,199,62,44,34,108,20,55,155,184,161,80,58,177,169,191,11,104,180,163,170,95,91,90,125,149,32,68,63,100,116,175,165,193,16,136,144,70,19,64,103,112,84,77,115,179,176,42,47,132,166,119,48];240;False
1928;8332;10260;[198,159,158,182,1,117,2,129,135,14,99,73,140,178,192,10,123,17,8,94,173,18,102,120,24,197,15,9,150,143,67,189,49,65,124,147,130,22,38,105,72,154,60,151,7,153,187,127,39,107,76,122,114,75,101,27,30,134,137,86,181,82,23,12,54,142,121,168,3,98,93,110,81,52,174,118,183,83,26,79,185,148,167,61,59,36,46,5,41,133,96,157,138,45,188,87,66,126,106,21,50,53,51,29,78,156,160,71,69,190,43,128,85,164,111,88,40,37,145,139,33,13,172,195,25,109,141,35,6,56,92,194,31,171,152,57,186,113,196,89,162,146,28,74,4,97,131,0,199,62,44,34,108,20,55,155,184,161,80,58,177,169,191,11,104,180,163,170,95,91,90,125,149,32,68,63,100,116,175,165,193,16,136,144,70,19,64,103,112,84,77,115,179,176,42,47,132,166,119,48];241;False
2862;7144;10006;[20,8,12,22,26,118,176,3,2,130,84,117,77,112,193,109,66,157,103,105,74,188,93,87,6,149,167,61,45,138,41,49,78,128,42,57,37,121,162,126,143,160,91,1,33,124,94,196,36,182,92,178,147,23,189,81,0,85,104,31,194,140,9,144,170,95,38,139,19,46,51,50,34,198,146,123,82,67,32,72,163,25,70,65,16,190,11,113,156,71,165,184,174,191,173,18,131,110,101,59,80,100,30,134,148,195,97,58,175,151,7,102,181,68,180,142,137,158,54,52,119,187,39,107,55,14,13,111,132,89,75,4,15,135,53,183,69,159,164,90,28,155,73,99,106,136,115,152,35,161,172,86,133,76,122,116,44,125,145,56,21,108,192,40,169,129,29,154,60,177,27,43,127,96,171,141,98,114,64,79,179,47,88,5,186,199,83,153,166,24,150,10,185,62,120,197,168,17,48,63];242;False
1996;8286;10282;[156,78,93,182,1,117,2,129,135,14,99,73,140,178,192,10,123,17,8,94,173,18,102,120,24,197,15,9,150,143,67,189,49,65,124,147,130,22,38,105,72,154,60,151,7,153,187,127,39,107,76,122,114,75,101,27,30,134,137,86,181,82,23,12,54,142,121,168,3,98,158,110,81,52,174,118,183,83,26,79,185,148,167,61,59,36,46,5,41,133,96,157,138,45,188,87,66,126,106,21,50,53,51,29,198,88,160,71,69,190,43,128,85,164,111,159,40,37,145,139,33,13,172,195,25,109,141,35,6,56,92,194,31,171,152,57,186,113,196,89,162,146,28,74,4,97,131,0,199,62,44,34,108,20,55,155,184,161,80,58,177,169,191,11,104,180,163,170,95,91,90,125,149,32,68,63,100,116,175,165,193,16,136,144,70,19,64,103,112,84,77,115,179,176,42,47,132,166,119,48];243;False
1931;8320;10251;[78,159,158,182,1,117,2,129,135,14,99,73,140,178,192,10,123,17,8,94,173,18,102,120,24,197,15,9,150,143,67,189,49,65,124,147,130,22,38,105,72,154,60,151,7,153,187,127,39,107,76,122,114,75,101,27,30,134,137,86,181,82,23,12,54,142,121,168,3,98,93,110,81,52,174,118,183,83,26,79,185,148,167,61,59,36,46,5,41,133,96,157,138,45,188,87,66,126,106,21,50,53,51,29,198,156,160,71,69,190,43,128,85,164,111,88,40,37,145,139,33,13,172,195,25,109,141,35,6,56,92,194,31,171,152,57,186,113,196,89,162,146,28,74,4,97,131,0,199,62,44,34,108,20,55,155,184,161,80,58,177,169,191,11,104,180,163,170,95,91,90,125,149,32,68,63,100,116,175,165,193,16,136,144,70,19,64,103,112,84,77,115,179,176,42,47,132,166,119,48];244;False
2712;7166;9878;[118,8,12,22,26,20,176,3,2,130,84,117,77,112,193,109,66,157,103,105,74,188,93,87,6,149,167,61,45,138,41,49,78,128,42,57,37,121,162,126,143,160,91,1,33,124,94,196,36,182,92,178,147,23,189,81,0,85,104,31,194,140,9,144,170,95,38,139,19,46,51,50,34,198,146,123,82,67,32,72,163,25,70,65,16,190,11,113,156,71,165,184,174,191,173,18,131,110,101,59,80,100,30,134,148,195,97,58,175,151,7,102,181,68,180,142,137,158,54,52,119,187,39,107,55,14,13,111,132,89,75,4,15,135,53,183,69,159,164,90,28,155,73,99,106,136,115,152,35,161,172,86,133,76,122,116,44,125,145,56,21,108,192,40,169,129,29,154,60,177,27,43,127,96,171,141,98,114,64,79,179,47,88,5,186,199,83,153,166,24,150,10,185,62,120,197,168,17,48,63];245;False
2027;8273;10300;[21,78,93,182,1,117,2,129,135,14,99,73,140,178,192,10,123,17,8,94,173,18,102,120,24,197,15,9,150,143,67,189,49,65,124,147,130,22,38,105,72,154,60,151,7,153,187,127,39,107,76,122,114,75,101,27,30,134,137,86,181,82,23,12,54,142,121,168,3,98,158,110,81,52,174,118,183,83,26,79,185,148,167,61,59,36,46,5,41,133,96,157,138,45,188,87,66,126,106,156,50,53,51,29,198,88,160,71,69,190,43,128,85,164,111,159,40,37,145,139,33,13,172,195,25,109,141,35,6,56,92,194,31,171,152,57,186,113,196,89,162,146,28,74,4,97,131,0,199,62,44,34,108,20,55,155,184,161,80,58,177,169,191,11,104,180,163,170,95,91,90,125,149,32,68,63,100,116,175,165,193,16,136,144,70,19,64,103,112,84,77,115,179,176,42,47,132,166,119,48];246;False
1904;8327;10231;[159,78,158,182,1,117,2,129,135,14,99,73,140,178,192,10,123,17,8,94,173,18,102,120,24,197,15,9,150,143,67,189,49,65,124,147,130,22,38,105,72,154,60,151,7,153,187,127,39,107,76,122,114,75,101,27,30,134,137,86,181,82,23,12,54,142,121,168,3,98,93,110,81,52,174,118,183,83,26,79,185,148,167,61,59,36,46,5,41,133,96,157,138,45,188,87,66,126,106,21,50,53,51,29,198,156,160,71,69,190,43,128,85,164,111,88,40,37,145,139,33,13,172,195,25,109,141,35,6,56,92,194,31,171,152,57,186,113,196,89,162,146,28,74,4,97,131,0,199,62,44,34,108,20,55,155,184,161,80,58,177,169,191,11,104,180,163,170,95,91,90,125,149,32,68,63,100,116,175,165,193,16,136,144,70,19,64,103,112,84,77,115,179,176,42,47,132,166,119,48];247;False
2020;8281;10301;[31,159,158,182,1,117,2,129,135,14,99,73,140,178,192,10,123,17,8,94,173,18,102,120,24,197,15,9,150,143,67,189,49,65,124,147,130,22,38,105,72,154,60,151,7,153,187,127,39,107,76,122,114,75,101,27,30,134,137,86,181,82,23,12,54,142,121,168,3,98,93,110,81,52,174,118,183,83,26,79,185,148,167,61,59,36,46,5,41,133,96,157,138,45,188,87,66,126,106,21,50,53,51,29,198,156,160,71,69,190,43,128,85,164,111,88,40,37,145,139,33,13,172,195,25,109,141,35,6,56,92,194,78,171,152,57,186,113,196,89,162,146,28,74,4,97,131,0,199,62,44,34,108,20,55,155,184,161,80,58,177,169,191,11,104,180,163,170,95,91,90,125,149,32,68,63,100,116,175,165,193,16,136,144,70,19,64,103,112,84,77,115,179,176,42,47,132,166,119,48];248;False
2717;7151;9868;[194,8,12,22,26,20,176,3,2,130,84,117,77,112,193,109,66,157,103,105,74,188,93,87,6,149,167,61,45,138,41,49,78,128,42,57,37,121,162,126,143,160,91,1,33,124,94,196,36,182,92,178,147,23,189,81,0,85,104,31,118,140,9,144,170,95,38,139,19,46,51,50,34,198,146,123,82,67,32,72,163,25,70,65,16,190,11,113,156,71,165,184,174,191,173,18,131,110,101,59,80,100,30,134,148,195,97,58,175,151,7,102,181,68,180,142,137,158,54,52,119,187,39,107,55,14,13,111,132,89,75,4,15,135,53,183,69,159,164,90,28,155,73,99,106,136,115,152,35,161,172,86,133,76,122,116,44,125,145,56,21,108,192,40,169,129,29,154,60,177,27,43,127,96,171,141,98,114,64,79,179,47,88,5,186,199,83,153,166,24,150,10,185,62,120,197,168,17,48,63];249;False
2080;8257;10337;[50,78,93,182,1,117,2,129,135,14,99,73,140,178,192,10,123,17,8,94,173,18,102,120,24,197,15,9,150,143,67,189,49,65,124,147,130,22,38,105,72,154,60,151,7,153,187,127,39,107,76,122,114,75,101,27,30,134,137,86,181,82,23,12,54,142,121,168,3,98,158,110,81,52,174,118,183,83,26,79,185,148,167,61,59,36,46,5,41,133,96,157,138,45,188,87,66,126,106,156,21,53,51,29,198,88,160,71,69,190,43,128,85,164,111,159,40,37,145,139,33,13,172,195,25,109,141,35,6,56,92,194,31,171,152,57,186,113,196,89,162,146,28,74,4,97,131,0,199,62,44,34,108,20,55,155,184,161,80,58,177,169,191,11,104,180,163,170,95,91,90,125,149,32,68,63,100,116,175,165,193,16,136,144,70,19,64,103,112,84,77,115,179,176,42,47,132,166,119,48];250;False
1968;8314;10282;[147,78,158,182,1,117,2,129,135,14,99,73,140,178,192,10,123,17,8,94,173,18,102,120,24,197,15,9,150,143,67,189,49,65,124,159,130,22,38,105,72,154,60,151,7,153,187,127,39,107,76,122,114,75,101,27,30,134,137,86,181,82,23,12,54,142,121,168,3,98,93,110,81,52,174,118,183,83,26,79,185,148,167,61,59,36,46,5,41,133,96,157,138,45,188,87,66,126,106,21,50,53,51,29,198,156,160,71,69,190,43,128,85,164,111,88,40,37,145,139,33,13,172,195,25,109,141,35,6,56,92,194,31,171,152,57,186,113,196,89,162,146,28,74,4,97,131,0,199,62,44,34,108,20,55,155,184,161,80,58,177,169,191,11,104,180,163,170,95,91,90,125,149,32,68,63,100,116,175,165,193,16,136,144,70,19,64,103,112,84,77,115,179,176,42,47,132,166,119,48];251;False
2079;8264;10343;[106,159,158,182,1,117,2,129,135,14,99,73,140,178,192,10,123,17,8,94,173,18,102,120,24,197,15,9,150,143,67,189,49,65,124,147,130,22,38,105,72,154,60,151,7,153,187,127,39,107,76,122,114,75,101,27,30,134,137,86,181,82,23,12,54,142,121,168,3,98,93,110,81,52,174,118,183,83,26,79,185,148,167,61,59,36,46,5,41,133,96,157,138,45,188,87,66,126,31,21,50,53,51,29,198,156,160,71,69,190,43,128,85,164,111,88,40,37,145,139,33,13,172,195,25,109,141,35,6,56,92,194,78,171,152,57,186,113,196,89,162,146,28,74,4,97,131,0,199,62,44,34,108,20,55,155,184,161,80,58,177,169,191,11,104,180,163,170,95,91,90,125,149,32,68,63,100,116,175,165,193,16,136,144,70,19,64,103,112,84,77,115,179,176,42,47,132,166,119,48];252;False
2705;7152;9857;[198,8,12,22,26,20,176,3,2,130,84,117,77,112,193,109,66,157,103,105,74,188,93,87,6,149,167,61,45,138,41,49,78,128,42,57,37,121,162,126,143,160,91,1,33,124,94,196,36,182,92,178,147,23,189,81,0,85,104,31,118,140,9,144,170,95,38,139,19,46,51,50,34,194,146,123,82,67,32,72,163,25,70,65,16,190,11,113,156,71,165,184,174,191,173,18,131,110,101,59,80,100,30,134,148,195,97,58,175,151,7,102,181,68,180,142,137,158,54,52,119,187,39,107,55,14,13,111,132,89,75,4,15,135,53,183,69,159,164,90,28,155,73,99,106,136,115,152,35,161,172,86,133,76,122,116,44,125,145,56,21,108,192,40,169,129,29,154,60,177,27,43,127,96,171,141,98,114,64,79,179,47,88,5,186,199,83,153,166,24,150,10,185,62,120,197,168,17,48,63];253;False
2068;8269;10337;[53,78,93,182,1,117,2,129,135,14,99,73,140,178,192,10,123,17,8,94,173,18,102,120,24,197,15,9,150,143,67,189,49,65,124,147,130,22,38,105,72,154,60,151,7,153,187,127,39,107,76,122,114,75,101,27,30,134,137,86,181,82,23,12,54,142,121,168,3,98,158,110,81,52,174,118,183,83,26,79,185,148,167,61,59,36,46,5,41,133,96,157,138,45,188,87,66,126,106,156,21,50,51,29,198,88,160,71,69,190,43,128,85,164,111,159,40,37,145,139,33,13,172,195,25,109,141,35,6,56,92,194,31,171,152,57,186,113,196,89,162,146,28,74,4,97,131,0,199,62,44,34,108,20,55,155,184,161,80,58,177,169,191,11,104,180,163,170,95,91,90,125,149,32,68,63,100,116,175,165,193,16,136,144,70,19,64,103,112,84,77,115,179,176,42,47,132,166,119,48];254;False
1963;8307;10270;[63,78,158,182,1,117,2,129,135,14,99,73,140,178,192,10,123,17,8,94,173,18,102,120,24,197,15,9,150,143,67,189,49,65,124,159,130,22,38,105,72,154,60,151,7,153,187,127,39,107,76,122,114,75,101,27,30,134,137,86,181,82,23,12,54,142,121,168,3,98,93,110,81,52,174,118,183,83,26,79,185,148,167,61,59,36,46,5,41,133,96,157,138,45,188,87,66,126,106,21,50,53,51,29,198,156,160,71,69,190,43,128,85,164,111,88,40,37,145,139,33,13,172,195,25,109,141,35,6,56,92,194,31,171,152,57,186,113,196,89,162,146,28,74,4,97,131,0,199,62,44,34,108,20,55,155,184,161,80,58,177,169,191,11,104,180,163,170,95,91,90,125,149,32,68,147,100,116,175,165,193,16,136,144,70,19,64,103,112,84,77,115,179,176,42,47,132,166,119,48];255;False
2057;8263;10320;[194,159,158,182,1,117,2,129,135,14,99,73,140,178,192,10,123,17,8,94,173,18,102,120,24,197,15,9,150,143,67,189,49,65,124,147,130,22,38,105,72,154,60,151,7,153,187,127,39,107,76,122,114,75,101,27,30,134,137,86,181,82,23,12,54,142,121,168,3,98,93,110,81,52,174,118,183,83,26,79,185,148,167,61,59,36,46,5,41,133,96,157,138,45,188,87,66,126,31,21,50,53,51,29,198,156,160,71,69,190,43,128,85,164,111,88,40,37,145,139,33,13,172,195,25,109,141,35,6,56,92,106,78,171,152,57,186,113,196,89,162,146,28,74,4,97,131,0,199,62,44,34,108,20,55,155,184,161,80,58,177,169,191,11,104,180,163,170,95,91,90,125,149,32,68,63,100,116,175,165,193,16,136,144,70,19,64,103,112,84,77,115,179,176,42,47,132,166,119,48];256;False
2684;7167;9851;[74,8,12,22,26,20,176,3,2,130,84,117,77,112,193,109,66,157,103,105,198,188,93,87,6,149,167,61,45,138,41,49,78,128,42,57,37,121,162,126,143,160,91,1,33,124,94,196,36,182,92,178,147,23,189,81,0,85,104,31,118,140,9,144,170,95,38,139,19,46,51,50,34,194,146,123,82,67,32,72,163,25,70,65,16,190,11,113,156,71,165,184,174,191,173,18,131,110,101,59,80,100,30,134,148,195,97,58,175,151,7,102,181,68,180,142,137,158,54,52,119,187,39,107,55,14,13,111,132,89,75,4,15,135,53,183,69,159,164,90,28,155,73,99,106,136,115,152,35,161,172,86,133,76,122,116,44,125,145,56,21,108,192,40,169,129,29,154,60,177,27,43,127,96,171,141,98,114,64,79,179,47,88,5,186,199,83,153,166,24,150,10,185,62,120,197,168,17,48,63];257;False
1962;8305;10267;[63,78,152,182,1,117,2,129,135,14,99,73,140,178,192,10,123,17,8,94,173,18,102,120,24,197,15,9,150,143,67,189,49,65,124,159,130,22,38,105,72,154,60,151,7,153,187,127,39,107,76,122,114,75,101,27,30,134,137,86,181,82,23,12,54,142,121,168,3,98,93,110,81,52,174,118,183,83,26,79,185,148,167,61,59,36,46,5,41,133,96,157,138,45,188,87,66,126,106,21,50,53,51,29,198,156,160,71,69,190,43,128,85,164,111,88,40,37,145,139,33,13,172,195,25,109,141,35,6,56,92,194,31,171,158,57,186,113,196,89,162,146,28,74,4,97,131,0,199,62,44,34,108,20,55,155,184,161,80,58,177,169,191,11,104,180,163,170,95,91,90,125,149,32,68,147,100,116,175,165,193,16,136,144,70,19,64,103,112,84,77,115,179,176,42,47,132,166,119,48];258;False
2035;8262;10297;[198,159,158,182,1,117,2,129,135,14,99,73,140,178,192,10,123,17,8,94,173,18,102,120,24,197,15,9,150,143,67,189,49,65,124,147,130,22,38,105,72,154,60,151,7,153,187,127,39,107,76,122,114,75,101,27,30,134,137,86,181,82,23,12,54,142,121,168,3,98,93,110,81,52,174,118,183,83,26,79,185,148,167,61,59,36,46,5,41,133,96,157,138,45,188,87,66,126,31,21,50,53,51,29,194,156,160,71,69,190,43,128,85,164,111,88,40,37,145,139,33,13,172,195,25,109,141,35,6,56,92,106,78,171,152,57,186,113,196,89,162,146,28,74,4,97,131,0,199,62,44,34,108,20,55,155,184,161,80,58,177,169,191,11,104,180,163,170,95,91,90,125,149,32,68,63,100,116,175,165,193,16,136,144,70,19,64,103,112,84,77,115,179,176,42,47,132,166,119,48];259;False
2647;7176;9823;[118,8,12,22,26,20,176,3,2,130,84,117,77,112,193,109,66,157,103,105,198,188,93,87,6,149,167,61,45,138,41,49,78,128,42,57,37,121,162,126,143,160,91,1,33,124,94,196,36,182,92,178,147,23,189,81,0,85,104,31,74,140,9,144,170,95,38,139,19,46,51,50,34,194,146,123,82,67,32,72,163,25,70,65,16,190,11,113,156,71,165,184,174,191,173,18,131,110,101,59,80,100,30,134,148,195,97,58,175,151,7,102,181,68,180,142,137,158,54,52,119,187,39,107,55,14,13,111,132,89,75,4,15,135,53,183,69,159,164,90,28,155,73,99,106,136,115,152,35,161,172,86,133,76,122,116,44,125,145,56,21,108,192,40,169,129,29,154,60,177,27,43,127,96,171,141,98,114,64,79,179,47,88,5,186,199,83,153,166,24,150,10,185,62,120,197,168,17,48,63];260;False
1942;8310;10252;[63,93,152,182,1,117,2,129,135,14,99,73,140,178,192,10,123,17,8,94,173,18,102,120,24,197,15,9,150,143,67,189,49,65,124,159,130,22,38,105,72,154,60,151,7,153,187,127,39,107,76,122,114,75,101,27,30,134,137,86,181,82,23,12,54,142,121,168,3,98,78,110,81,52,174,118,183,83,26,79,185,148,167,61,59,36,46,5,41,133,96,157,138,45,188,87,66,126,106,21,50,53,51,29,198,156,160,71,69,190,43,128,85,164,111,88,40,37,145,139,33,13,172,195,25,109,141,35,6,56,92,194,31,171,158,57,186,113,196,89,162,146,28,74,4,97,131,0,199,62,44,34,108,20,55,155,184,161,80,58,177,169,191,11,104,180,163,170,95,91,90,125,149,32,68,147,100,116,175,165,193,16,136,144,70,19,64,103,112,84,77,115,179,176,42,47,132,166,119,48];261;False
2015;8259;10274;[198,88,158,182,1,117,2,129,135,14,99,73,140,178,192,10,123,17,8,94,173,18,102,120,24,197,15,9,150,143,67,189,49,65,124,147,130,22,38,105,72,154,60,151,7,153,187,127,39,107,76,122,114,75,101,27,30,134,137,86,181,82,23,12,54,142,121,168,3,98,93,110,81,52,174,118,183,83,26,79,185,148,167,61,59,36,46,5,41,133,96,157,138,45,188,87,66,126,31,21,50,53,51,29,194,156,160,71,69,190,43,128,85,164,111,159,40,37,145,139,33,13,172,195,25,109,141,35,6,56,92,106,78,171,152,57,186,113,196,89,162,146,28,74,4,97,131,0,199,62,44,34,108,20,55,155,184,161,80,58,177,169,191,11,104,180,163,170,95,91,90,125,149,32,68,63,100,116,175,165,193,16,136,144,70,19,64,103,112,84,77,115,179,176,42,47,132,166,119,48];262;False
2663;7170;9833;[180,8,12,22,26,20,176,3,2,130,84,117,77,112,193,109,66,157,103,105,198,188,93,87,6,149,167,61,45,138,41,49,78,128,42,57,37,121,162,126,143,160,91,1,33,124,94,196,36,182,92,178,147,23,189,81,0,85,104,31,74,140,9,144,170,95,38,139,19,46,51,50,34,194,146,123,82,67,32,72,163,25,70,65,16,190,11,113,156,71,165,184,174,191,173,18,131,110,101,59,80,100,30,134,148,195,97,58,175,151,7,102,181,68,118,142,137,158,54,52,119,187,39,107,55,14,13,111,132,89,75,4,15,135,53,183,69,159,164,90,28,155,73,99,106,136,115,152,35,161,172,86,133,76,122,116,44,125,145,56,21,108,192,40,169,129,29,154,60,177,27,43,127,96,171,141,98,114,64,79,179,47,88,5,186,199,83,153,166,24,150,10,185,62,120,197,168,17,48,63];263;False
1929;8319;10248;[63,93,152,112,1,117,2,129,135,14,99,73,140,178,192,10,123,17,8,94,173,18,102,120,24,197,15,9,150,143,67,189,49,65,124,159,130,22,38,105,72,154,60,151,7,153,187,127,39,107,76,122,114,75,101,27,30,134,137,86,181,82,23,12,54,142,121,168,3,98,78,110,81,52,174,118,183,83,26,79,185,148,167,61,59,36,46,5,41,133,96,157,138,45,188,87,66,126,106,21,50,53,51,29,198,156,160,71,69,190,43,128,85,164,111,88,40,37,145,139,33,13,172,195,25,109,141,35,6,56,92,194,31,171,158,57,186,113,196,89,162,146,28,74,4,97,131,0,199,62,44,34,108,20,55,155,184,161,80,58,177,169,191,11,104,180,163,170,95,91,90,125,149,32,68,147,100,116,175,165,193,16,136,144,70,19,64,103,182,84,77,115,179,176,42,47,132,166,119,48];264;False
2062;8251;10313;[146,88,158,182,1,117,2,129,135,14,99,73,140,178,192,10,123,17,8,94,173,18,102,120,24,197,15,9,150,143,67,189,49,65,124,147,130,22,38,105,72,154,60,151,7,153,187,127,39,107,76,122,114,75,101,27,30,134,137,86,181,82,23,12,54,142,121,168,3,98,93,110,81,52,174,118,183,83,26,79,185,148,167,61,59,36,46,5,41,133,96,157,138,45,188,87,66,126,31,21,50,53,51,29,194,156,160,71,69,190,43,128,85,164,111,159,40,37,145,139,33,13,172,195,25,109,141,35,6,56,92,106,78,171,152,57,186,113,196,89,162,198,28,74,4,97,131,0,199,62,44,34,108,20,55,155,184,161,80,58,177,169,191,11,104,180,163,170,95,91,90,125,149,32,68,63,100,116,175,165,193,16,136,144,70,19,64,103,112,84,77,115,179,176,42,47,132,166,119,48];265;False
2698;7166;9864;[198,8,12,22,26,20,176,3,2,130,84,117,77,112,193,109,66,157,103,105,180,188,93,87,6,149,167,61,45,138,41,49,78,128,42,57,37,121,162,126,143,160,91,1,33,124,94,196,36,182,92,178,147,23,189,81,0,85,104,31,74,140,9,144,170,95,38,139,19,46,51,50,34,194,146,123,82,67,32,72,163,25,70,65,16,190,11,113,156,71,165,184,174,191,173,18,131,110,101,59,80,100,30,134,148,195,97,58,175,151,7,102,181,68,118,142,137,158,54,52,119,187,39,107,55,14,13,111,132,89,75,4,15,135,53,183,69,159,164,90,28,155,73,99,106,136,115,152,35,161,172,86,133,76,122,116,44,125,145,56,21,108,192,40,169,129,29,154,60,177,27,43,127,96,171,141,98,114,64,79,179,47,88,5,186,199,83,153,166,24,150,10,185,62,120,197,168,17,48,63];266;False
1987;8298;10285;[63,93,49,112,1,117,2,129,135,14,99,73,140,178,192,10,123,17,8,94,173,18,102,120,24,197,15,9,150,143,67,189,152,65,124,159,130,22,38,105,72,154,60,151,7,153,187,127,39,107,76,122,114,75,101,27,30,134,137,86,181,82,23,12,54,142,121,168,3,98,78,110,81,52,174,118,183,83,26,79,185,148,167,61,59,36,46,5,41,133,96,157,138,45,188,87,66,126,106,21,50,53,51,29,198,156,160,71,69,190,43,128,85,164,111,88,40,37,145,139,33,13,172,195,25,109,141,35,6,56,92,194,31,171,158,57,186,113,196,89,162,146,28,74,4,97,131,0,199,62,44,34,108,20,55,155,184,161,80,58,177,169,191,11,104,180,163,170,95,91,90,125,149,32,68,147,100,116,175,165,193,16,136,144,70,19,64,103,182,84,77,115,179,176,42,47,132,166,119,48];267;False
2080;8249;10329;[31,88,158,182,1,117,2,129,135,14,99,73,140,178,192,10,123,17,8,94,173,18,102,120,24,197,15,9,150,143,67,189,49,65,124,147,130,22,38,105,72,154,60,151,7,153,187,127,39,107,76,122,114,75,101,27,30,134,137,86,181,82,23,12,54,142,121,168,3,98,93,110,81,52,174,118,183,83,26,79,185,148,167,61,59,36,46,5,41,133,96,157,138,45,188,87,66,126,146,21,50,53,51,29,194,156,160,71,69,190,43,128,85,164,111,159,40,37,145,139,33,13,172,195,25,109,141,35,6,56,92,106,78,171,152,57,186,113,196,89,162,198,28,74,4,97,131,0,199,62,44,34,108,20,55,155,184,161,80,58,177,169,191,11,104,180,163,170,95,91,90,125,149,32,68,63,100,116,175,165,193,16,136,144,70,19,64,103,112,84,77,115,179,176,42,47,132,166,119,48];268;False
2596;7188;9784;[118,8,12,22,26,20,176,3,2,130,84,117,77,112,193,109,66,157,103,105,180,188,93,87,6,149,167,61,45,138,41,49,78,128,42,57,37,121,162,126,143,160,91,1,33,124,94,196,36,182,92,178,147,23,189,81,0,85,104,31,74,140,9,144,170,95,38,139,19,46,51,50,34,194,146,123,82,67,32,72,163,25,70,65,16,190,11,113,156,71,165,184,174,191,173,18,131,110,101,59,80,100,30,134,148,195,97,58,175,151,7,102,181,68,198,142,137,158,54,52,119,187,39,107,55,14,13,111,132,89,75,4,15,135,53,183,69,159,164,90,28,155,73,99,106,136,115,152,35,161,172,86,133,76,122,116,44,125,145,56,21,108,192,40,169,129,29,154,60,177,27,43,127,96,171,141,98,114,64,79,179,47,88,5,186,199,83,153,166,24,150,10,185,62,120,197,168,17,48,63];269;True
1974;8289;10263;[63,78,49,112,1,117,2,129,135,14,99,73,140,178,192,10,123,17,8,94,173,18,102,120,24,197,15,9,150,143,67,189,152,65,124,159,130,22,38,105,72,154,60,151,7,153,187,127,39,107,76,122,114,75,101,27,30,134,137,86,181,82,23,12,54,142,121,168,3,98,93,110,81,52,174,118,183,83,26,79,185,148,167,61,59,36,46,5,41,133,96,157,138,45,188,87,66,126,106,21,50,53,51,29,198,156,160,71,69,190,43,128,85,164,111,88,40,37,145,139,33,13,172,195,25,109,141,35,6,56,92,194,31,171,158,57,186,113,196,89,162,146,28,74,4,97,131,0,199,62,44,34,108,20,55,155,184,161,80,58,177,169,191,11,104,180,163,170,95,91,90,125,149,32,68,147,100,116,175,165,193,16,136,144,70,19,64,103,182,84,77,115,179,176,42,47,132,166,119,48];270;False
2089;8241;10330;[91,88,158,182,1,117,2,129,135,14,99,73,140,178,192,10,123,17,8,94,173,18,102,120,24,197,15,9,150,143,67,189,49,65,124,147,130,22,38,105,72,154,60,151,7,153,187,127,39,107,76,122,114,75,101,27,30,134,137,86,181,82,23,12,54,142,121,168,3,98,93,110,81,52,174,118,183,83,26,79,185,148,167,61,59,36,46,5,41,133,96,157,138,45,188,87,66,126,146,21,50,53,51,29,194,156,160,71,69,190,43,128,85,164,111,159,40,37,145,139,33,13,172,195,25,109,141,35,6,56,92,106,78,171,152,57,186,113,196,89,162,198,28,74,4,97,131,0,199,62,44,34,108,20,55,155,184,161,80,58,177,169,191,11,104,180,163,170,95,31,90,125,149,32,68,63,100,116,175,165,193,16,136,144,70,19,64,103,112,84,77,115,179,176,42,47,132,166,119,48];271;False
2585;7203;9788;[143,8,12,22,26,20,176,3,2,130,84,117,77,112,193,109,66,157,103,105,180,188,93,87,6,149,167,61,45,138,41,49,78,128,42,57,37,121,162,126,118,160,91,1,33,124,94,196,36,182,92,178,147,23,189,81,0,85,104,31,74,140,9,144,170,95,38,139,19,46,51,50,34,194,146,123,82,67,32,72,163,25,70,65,16,190,11,113,156,71,165,184,174,191,173,18,131,110,101,59,80,100,30,134,148,195,97,58,175,151,7,102,181,68,198,142,137,158,54,52,119,187,39,107,55,14,13,111,132,89,75,4,15,135,53,183,69,159,164,90,28,155,73,99,106,136,115,152,35,161,172,86,133,76,122,116,44,125,145,56,21,108,192,40,169,129,29,154,60,177,27,43,127,96,171,141,98,114,64,79,179,47,88,5,186,199,83,153,166,24,150,10,185,62,120,197,168,17,48,63];272;True
2057;8257;10314;[63,154,49,112,1,117,2,129,135,14,99,73,140,178,192,10,123,17,8,94,173,18,102,120,24,197,15,9,150,143,67,189,152,65,124,159,130,22,38,105,72,78,60,151,7,153,187,127,39,107,76,122,114,75,101,27,30,134,137,86,181,82,23,12,54,142,121,168,3,98,93,110,81,52,174,118,183,83,26,79,185,148,167,61,59,36,46,5,41,133,96,157,138,45,188,87,66,126,106,21,50,53,51,29,198,156,160,71,69,190,43,128,85,164,111,88,40,37,145,139,33,13,172,195,25,109,141,35,6,56,92,194,31,171,158,57,186,113,196,89,162,146,28,74,4,97,131,0,199,62,44,34,108,20,55,155,184,161,80,58,177,169,191,11,104,180,163,170,95,91,90,125,149,32,68,147,100,116,175,165,193,16,136,144,70,19,64,103,182,84,77,115,179,176,42,47,132,166,119,48];273;False
2051;8256;10307;[194,88,158,182,1,117,2,129,135,14,99,73,140,178,192,10,123,17,8,94,173,18,102,120,24,197,15,9,150,143,67,189,49,65,124,147,130,22,38,105,72,154,60,151,7,153,187,127,39,107,76,122,114,75,101,27,30,134,137,86,181,82,23,12,54,142,121,168,3,98,93,110,81,52,174,118,183,83,26,79,185,148,167,61,59,36,46,5,41,133,96,157,138,45,188,87,66,126,146,21,50,53,51,29,91,156,160,71,69,190,43,128,85,164,111,159,40,37,145,139,33,13,172,195,25,109,141,35,6,56,92,106,78,171,152,57,186,113,196,89,162,198,28,74,4,97,131,0,199,62,44,34,108,20,55,155,184,161,80,58,177,169,191,11,104,180,163,170,95,31,90,125,149,32,68,63,100,116,175,165,193,16,136,144,70,19,64,103,112,84,77,115,179,176,42,47,132,166,119,48];274;False
2633;7180;9813;[143,8,12,22,26,20,176,3,2,130,84,117,77,132,193,109,66,157,103,105,180,188,93,87,6,149,167,61,45,138,41,49,78,128,42,57,37,121,162,126,118,160,91,1,33,124,94,196,36,182,92,178,147,23,189,81,0,85,104,31,74,140,9,144,170,95,38,139,19,46,51,50,34,194,146,123,82,67,32,72,163,25,70,65,16,190,11,113,156,71,165,184,174,191,173,18,131,110,101,59,80,100,30,134,148,195,97,58,175,151,7,102,181,68,198,142,137,158,54,52,119,187,39,107,55,14,13,111,112,89,75,4,15,135,53,183,69,159,164,90,28,155,73,99,106,136,115,152,35,161,172,86,133,76,122,116,44,125,145,56,21,108,192,40,169,129,29,154,60,177,27,43,127,96,171,141,98,114,64,79,179,47,88,5,186,199,83,153,166,24,150,10,185,62,120,197,168,17,48,63];275;True
2064;8240;10304;[194,102,158,182,1,117,2,129,135,14,99,73,140,178,192,10,123,17,8,94,173,18,88,120,24,197,15,9,150,143,67,189,49,65,124,147,130,22,38,105,72,154,60,151,7,153,187,127,39,107,76,122,114,75,101,27,30,134,137,86,181,82,23,12,54,142,121,168,3,98,93,110,81,52,174,118,183,83,26,79,185,148,167,61,59,36,46,5,41,133,96,157,138,45,188,87,66,126,146,21,50,53,51,29,91,156,160,71,69,190,43,128,85,164,111,159,40,37,145,139,33,13,172,195,25,109,141,35,6,56,92,106,78,171,152,57,186,113,196,89,162,198,28,74,4,97,131,0,199,62,44,34,108,20,55,155,184,161,80,58,177,169,191,11,104,180,163,170,95,31,90,125,149,32,68,63,100,116,175,165,193,16,136,144,70,19,64,103,112,84,77,115,179,176,42,47,132,166,119,48];276;False
2644;7165;9809;[118,8,12,22,26,20,176,3,2,130,84,117,77,132,193,109,66,157,103,105,180,188,93,87,6,149,167,61,45,138,41,49,78,128,42,57,37,121,162,126,143,160,91,1,33,124,94,196,36,182,92,178,147,23,189,81,0,85,104,31,74,140,9,144,170,95,38,139,19,46,51,50,34,194,146,123,82,67,32,72,163,25,70,65,16,190,11,113,156,71,165,184,174,191,173,18,131,110,101,59,80,100,30,134,148,195,97,58,175,151,7,102,181,68,198,142,137,158,54,52,119,187,39,107,55,14,13,111,112,89,75,4,15,135,53,183,69,159,164,90,28,155,73,99,106,136,115,152,35,161,172,86,133,76,122,116,44,125,145,56,21,108,192,40,169,129,29,154,60,177,27,43,127,96,171,141,98,114,64,79,179,47,88,5,186,199,83,153,166,24,150,10,185,62,120,197,168,17,48,63];277;True
2067;8224;10291;[194,102,114,182,1,117,2,129,135,14,99,73,140,178,192,10,123,17,8,94,173,18,88,120,24,197,15,9,150,143,67,189,49,65,124,147,130,22,38,105,72,154,60,151,7,153,187,127,39,107,76,122,158,75,101,27,30,134,137,86,181,82,23,12,54,142,121,168,3,98,93,110,81,52,174,118,183,83,26,79,185,148,167,61,59,36,46,5,41,133,96,157,138,45,188,87,66,126,146,21,50,53,51,29,91,156,160,71,69,190,43,128,85,164,111,159,40,37,145,139,33,13,172,195,25,109,141,35,6,56,92,106,78,171,152,57,186,113,196,89,162,198,28,74,4,97,131,0,199,62,44,34,108,20,55,155,184,161,80,58,177,169,191,11,104,180,163,170,95,31,90,125,149,32,68,63,100,116,175,165,193,16,136,144,70,19,64,103,112,84,77,115,179,176,42,47,132,166,119,48];278;False
2794;7143;9937;[20,8,12,22,26,118,176,3,2,130,84,117,77,132,193,109,66,157,103,105,180,188,93,87,6,149,167,61,45,138,41,49,78,128,42,57,37,121,162,126,143,160,91,1,33,124,94,196,36,182,92,178,147,23,189,81,0,85,104,31,74,140,9,144,170,95,38,139,19,46,51,50,34,194,146,123,82,67,32,72,163,25,70,65,16,190,11,113,156,71,165,184,174,191,173,18,131,110,101,59,80,100,30,134,148,195,97,58,175,151,7,102,181,68,198,142,137,158,54,52,119,187,39,107,55,14,13,111,112,89,75,4,15,135,53,183,69,159,164,90,28,155,73,99,106,136,115,152,35,161,172,86,133,76,122,116,44,125,145,56,21,108,192,40,169,129,29,154,60,177,27,43,127,96,171,141,98,114,64,79,179,47,88,5,186,199,83,153,166,24,150,10,185,62,120,197,168,17,48,63];279;False
2047;8248;10295;[194,158,114,182,1,117,2,129,135,14,99,73,140,178,192,10,123,17,8,94,173,18,88,120,24,197,15,9,150,143,67,189,49,65,124,147,130,22,38,105,72,154,60,151,7,153,187,127,39,107,76,122,102,75,101,27,30,134,137,86,181,82,23,12,54,142,121,168,3,98,93,110,81,52,174,118,183,83,26,79,185,148,167,61,59,36,46,5,41,133,96,157,138,45,188,87,66,126,146,21,50,53,51,29,91,156,160,71,69,190,43,128,85,164,111,159,40,37,145,139,33,13,172,195,25,109,141,35,6,56,92,106,78,171,152,57,186,113,196,89,162,198,28,74,4,97,131,0,199,62,44,34,108,20,55,155,184,161,80,58,177,169,191,11,104,180,163,170,95,31,90,125,149,32,68,63,100,116,175,165,193,16,136,144,70,19,64,103,112,84,77,115,179,176,42,47,132,166,119,48];280;False
2700;7149;9849;[180,8,12,22,26,118,176,3,2,130,84,117,77,132,193,109,66,157,103,105,20,188,93,87,6,149,167,61,45,138,41,49,78,128,42,57,37,121,162,126,143,160,91,1,33,124,94,196,36,182,92,178,147,23,189,81,0,85,104,31,74,140,9,144,170,95,38,139,19,46,51,50,34,194,146,123,82,67,32,72,163,25,70,65,16,190,11,113,156,71,165,184,174,191,173,18,131,110,101,59,80,100,30,134,148,195,97,58,175,151,7,102,181,68,198,142,137,158,54,52,119,187,39,107,55,14,13,111,112,89,75,4,15,135,53,183,69,159,164,90,28,155,73,99,106,136,115,152,35,161,172,86,133,76,122,116,44,125,145,56,21,108,192,40,169,129,29,154,60,177,27,43,127,96,171,141,98,114,64,79,179,47,88,5,186,199,83,153,166,24,150,10,185,62,120,197,168,17,48,63];281;True
1993;8274;10267;[67,158,114,182,1,117,2,129,135,14,99,73,140,178,192,10,123,17,8,94,173,18,88,120,24,197,15,9,150,143,194,189,49,65,124,147,130,22,38,105,72,154,60,151,7,153,187,127,39,107,76,122,102,75,101,27,30,134,137,86,181,82,23,12,54,142,121,168,3,98,93,110,81,52,174,118,183,83,26,79,185,148,167,61,59,36,46,5,41,133,96,157,138,45,188,87,66,126,146,21,50,53,51,29,91,156,160,71,69,190,43,128,85,164,111,159,40,37,145,139,33,13,172,195,25,109,141,35,6,56,92,106,78,171,152,57,186,113,196,89,162,198,28,74,4,97,131,0,199,62,44,34,108,20,55,155,184,161,80,58,177,169,191,11,104,180,163,170,95,31,90,125,149,32,68,63,100,116,175,165,193,16,136,144,70,19,64,103,112,84,77,115,179,176,42,47,132,166,119,48];282;False
2678;7163;9841;[94,8,12,22,26,118,176,3,2,130,84,117,77,132,193,109,66,157,103,105,20,188,93,87,6,149,167,61,45,138,41,49,78,128,42,57,37,121,162,126,143,160,91,1,33,124,180,196,36,182,92,178,147,23,189,81,0,85,104,31,74,140,9,144,170,95,38,139,19,46,51,50,34,194,146,123,82,67,32,72,163,25,70,65,16,190,11,113,156,71,165,184,174,191,173,18,131,110,101,59,80,100,30,134,148,195,97,58,175,151,7,102,181,68,198,142,137,158,54,52,119,187,39,107,55,14,13,111,112,89,75,4,15,135,53,183,69,159,164,90,28,155,73,99,106,136,115,152,35,161,172,86,133,76,122,116,44,125,145,56,21,108,192,40,169,129,29,154,60,177,27,43,127,96,171,141,98,114,64,79,179,47,88,5,186,199,83,153,166,24,150,10,185,62,120,197,168,17,48,63];283;True
1973;8293;10266;[67,158,75,182,1,117,2,129,135,14,99,73,140,178,192,10,123,17,8,94,173,18,88,120,24,197,15,9,150,143,194,189,49,65,124,147,130,22,38,105,72,154,60,151,7,153,187,127,39,107,76,122,102,114,101,27,30,134,137,86,181,82,23,12,54,142,121,168,3,98,93,110,81,52,174,118,183,83,26,79,185,148,167,61,59,36,46,5,41,133,96,157,138,45,188,87,66,126,146,21,50,53,51,29,91,156,160,71,69,190,43,128,85,164,111,159,40,37,145,139,33,13,172,195,25,109,141,35,6,56,92,106,78,171,152,57,186,113,196,89,162,198,28,74,4,97,131,0,199,62,44,34,108,20,55,155,184,161,80,58,177,169,191,11,104,180,163,170,95,31,90,125,149,32,68,63,100,116,175,165,193,16,136,144,70,19,64,103,112,84,77,115,179,176,42,47,132,166,119,48];284;False
2682;7158;9840;[118,8,12,22,26,94,176,3,2,130,84,117,77,132,193,109,66,157,103,105,20,188,93,87,6,149,167,61,45,138,41,49,78,128,42,57,37,121,162,126,143,160,91,1,33,124,180,196,36,182,92,178,147,23,189,81,0,85,104,31,74,140,9,144,170,95,38,139,19,46,51,50,34,194,146,123,82,67,32,72,163,25,70,65,16,190,11,113,156,71,165,184,174,191,173,18,131,110,101,59,80,100,30,134,148,195,97,58,175,151,7,102,181,68,198,142,137,158,54,52,119,187,39,107,55,14,13,111,112,89,75,4,15,135,53,183,69,159,164,90,28,155,73,99,106,136,115,152,35,161,172,86,133,76,122,116,44,125,145,56,21,108,192,40,169,129,29,154,60,177,27,43,127,96,171,141,98,114,64,79,179,47,88,5,186,199,83,153,166,24,150,10,185,62,120,197,168,17,48,63];285;True
1969;8288;10257;[67,88,75,182,1,117,2,129,135,14,99,73,140,178,192,10,123,17,8,94,173,18,158,120,24,197,15,9,150,143,194,189,49,65,124,147,130,22,38,105,72,154,60,151,7,153,187,127,39,107,76,122,102,114,101,27,30,134,137,86,181,82,23,12,54,142,121,168,3,98,93,110,81,52,174,118,183,83,26,79,185,148,167,61,59,36,46,5,41,133,96,157,138,45,188,87,66,126,146,21,50,53,51,29,91,156,160,71,69,190,43,128,85,164,111,159,40,37,145,139,33,13,172,195,25,109,141,35,6,56,92,106,78,171,152,57,186,113,196,89,162,198,28,74,4,97,131,0,199,62,44,34,108,20,55,155,184,161,80,58,177,169,191,11,104,180,163,170,95,31,90,125,149,32,68,63,100,116,175,165,193,16,136,144,70,19,64,103,112,84,77,115,179,176,42,47,132,166,119,48];286;False
2748;7136;9884;[194,8,12,22,26,94,176,3,2,130,84,117,77,132,193,109,66,157,103,105,20,188,93,87,6,149,167,61,45,138,41,49,78,128,42,57,37,121,162,126,143,160,91,1,33,124,180,196,36,182,92,178,147,23,189,81,0,85,104,31,74,140,9,144,170,95,38,139,19,46,51,50,34,118,146,123,82,67,32,72,163,25,70,65,16,190,11,113,156,71,165,184,174,191,173,18,131,110,101,59,80,100,30,134,148,195,97,58,175,151,7,102,181,68,198,142,137,158,54,52,119,187,39,107,55,14,13,111,112,89,75,4,15,135,53,183,69,159,164,90,28,155,73,99,106,136,115,152,35,161,172,86,133,76,122,116,44,125,145,56,21,108,192,40,169,129,29,154,60,177,27,43,127,96,171,141,98,114,64,79,179,47,88,5,186,199,83,153,166,24,150,10,185,62,120,197,168,17,48,63];287;True
2008;8250;10258;[194,88,75,182,1,117,2,129,135,14,99,73,140,178,192,10,123,17,8,94,173,18,158,120,24,197,15,9,150,143,67,189,49,65,124,147,130,22,38,105,72,154,60,151,7,153,187,127,39,107,76,122,102,114,101,27,30,134,137,86,181,82,23,12,54,142,121,168,3,98,93,110,81,52,174,118,183,83,26,79,185,148,167,61,59,36,46,5,41,133,96,157,138,45,188,87,66,126,146,21,50,53,51,29,91,156,160,71,69,190,43,128,85,164,111,159,40,37,145,139,33,13,172,195,25,109,141,35,6,56,92,106,78,171,152,57,186,113,196,89,162,198,28,74,4,97,131,0,199,62,44,34,108,20,55,155,184,161,80,58,177,169,191,11,104,180,163,170,95,31,90,125,149,32,68,63,100,116,175,165,193,16,136,144,70,19,64,103,112,84,77,115,179,176,42,47,132,166,119,48];288;False
2864;7134;9998;[20,8,12,22,26,94,176,3,2,130,84,117,77,132,193,109,66,157,103,105,194,188,93,87,6,149,167,61,45,138,41,49,78,128,42,57,37,121,162,126,143,160,91,1,33,124,180,196,36,182,92,178,147,23,189,81,0,85,104,31,74,140,9,144,170,95,38,139,19,46,51,50,34,118,146,123,82,67,32,72,163,25,70,65,16,190,11,113,156,71,165,184,174,191,173,18,131,110,101,59,80,100,30,134,148,195,97,58,175,151,7,102,181,68,198,142,137,158,54,52,119,187,39,107,55,14,13,111,112,89,75,4,15,135,53,183,69,159,164,90,28,155,73,99,106,136,115,152,35,161,172,86,133,76,122,116,44,125,145,56,21,108,192,40,169,129,29,154,60,177,27,43,127,96,171,141,98,114,64,79,179,47,88,5,186,199,83,153,166,24,150,10,185,62,120,197,168,17,48,63];289;True
2006;8266;10272;[49,88,75,182,1,117,2,129,135,14,99,73,140,178,192,10,123,17,8,94,173,18,158,120,24,197,15,9,150,143,67,189,194,65,124,147,130,22,38,105,72,154,60,151,7,153,187,127,39,107,76,122,102,114,101,27,30,134,137,86,181,82,23,12,54,142,121,168,3,98,93,110,81,52,174,118,183,83,26,79,185,148,167,61,59,36,46,5,41,133,96,157,138,45,188,87,66,126,146,21,50,53,51,29,91,156,160,71,69,190,43,128,85,164,111,159,40,37,145,139,33,13,172,195,25,109,141,35,6,56,92,106,78,171,152,57,186,113,196,89,162,198,28,74,4,97,131,0,199,62,44,34,108,20,55,155,184,161,80,58,177,169,191,11,104,180,163,170,95,31,90,125,149,32,68,63,100,116,175,165,193,16,136,144,70,19,64,103,112,84,77,115,179,176,42,47,132,166,119,48];290;False
2991;7133;10124;[20,94,12,22,26,8,176,3,2,130,84,117,77,132,193,109,66,157,103,105,194,188,93,87,6,149,167,61,45,138,41,49,78,128,42,57,37,121,162,126,143,160,91,1,33,124,180,196,36,182,92,178,147,23,189,81,0,85,104,31,74,140,9,144,170,95,38,139,19,46,51,50,34,118,146,123,82,67,32,72,163,25,70,65,16,190,11,113,156,71,165,184,174,191,173,18,131,110,101,59,80,100,30,134,148,195,97,58,175,151,7,102,181,68,198,142,137,158,54,52,119,187,39,107,55,14,13,111,112,89,75,4,15,135,53,183,69,159,164,90,28,155,73,99,106,136,115,152,35,161,172,86,133,76,122,116,44,125,145,56,21,108,192,40,169,129,29,154,60,177,27,43,127,96,171,141,98,114,64,79,179,47,88,5,186,199,83,153,166,24,150,10,185,62,120,197,168,17,48,63];291;False
2025;8249;10274;[143,88,75,182,1,117,2,129,135,14,99,73,140,178,192,10,123,17,8,94,173,18,158,120,24,197,15,9,150,49,67,189,194,65,124,147,130,22,38,105,72,154,60,151,7,153,187,127,39,107,76,122,102,114,101,27,30,134,137,86,181,82,23,12,54,142,121,168,3,98,93,110,81,52,174,118,183,83,26,79,185,148,167,61,59,36,46,5,41,133,96,157,138,45,188,87,66,126,146,21,50,53,51,29,91,156,160,71,69,190,43,128,85,164,111,159,40,37,145,139,33,13,172,195,25,109,141,35,6,56,92,106,78,171,152,57,186,113,196,89,162,198,28,74,4,97,131,0,199,62,44,34,108,20,55,155,184,161,80,58,177,169,191,11,104,180,163,170,95,31,90,125,149,32,68,63,100,116,175,165,193,16,136,144,70,19,64,103,112,84,77,115,179,176,42,47,132,166,119,48];292;False
2974;7133;10107;[194,94,12,22,26,8,176,3,2,130,84,117,77,132,193,109,66,157,103,105,20,188,93,87,6,149,167,61,45,138,41,49,78,128,42,57,37,121,162,126,143,160,91,1,33,124,180,196,36,182,92,178,147,23,189,81,0,85,104,31,74,140,9,144,170,95,38,139,19,46,51,50,34,118,146,123,82,67,32,72,163,25,70,65,16,190,11,113,156,71,165,184,174,191,173,18,131,110,101,59,80,100,30,134,148,195,97,58,175,151,7,102,181,68,198,142,137,158,54,52,119,187,39,107,55,14,13,111,112,89,75,4,15,135,53,183,69,159,164,90,28,155,73,99,106,136,115,152,35,161,172,86,133,76,122,116,44,125,145,56,21,108,192,40,169,129,29,154,60,177,27,43,127,96,171,141,98,114,64,79,179,47,88,5,186,199,83,153,166,24,150,10,185,62,120,197,168,17,48,63];293;False
1949;8274;10223;[146,88,75,182,1,117,2,129,135,14,99,73,140,178,192,10,123,17,8,94,173,18,158,120,24,197,15,9,150,49,67,189,194,65,124,147,130,22,38,105,72,154,60,151,7,153,187,127,39,107,76,122,102,114,101,27,30,134,137,86,181,82,23,12,54,142,121,168,3,98,93,110,81,52,174,118,183,83,26,79,185,148,167,61,59,36,46,5,41,133,96,157,138,45,188,87,66,126,143,21,50,53,51,29,91,156,160,71,69,190,43,128,85,164,111,159,40,37,145,139,33,13,172,195,25,109,141,35,6,56,92,106,78,171,152,57,186,113,196,89,162,198,28,74,4,97,131,0,199,62,44,34,108,20,55,155,184,161,80,58,177,169,191,11,104,180,163,170,95,31,90,125,149,32,68,63,100,116,175,165,193,16,136,144,70,19,64,103,112,84,77,115,179,176,42,47,132,166,119,48];294;False
2978;7130;10108;[194,138,12,22,26,8,176,3,2,130,84,117,77,132,193,109,66,157,103,105,20,188,93,87,6,149,167,61,45,94,41,49,78,128,42,57,37,121,162,126,143,160,91,1,33,124,180,196,36,182,92,178,147,23,189,81,0,85,104,31,74,140,9,144,170,95,38,139,19,46,51,50,34,118,146,123,82,67,32,72,163,25,70,65,16,190,11,113,156,71,165,184,174,191,173,18,131,110,101,59,80,100,30,134,148,195,97,58,175,151,7,102,181,68,198,142,137,158,54,52,119,187,39,107,55,14,13,111,112,89,75,4,15,135,53,183,69,159,164,90,28,155,73,99,106,136,115,152,35,161,172,86,133,76,122,116,44,125,145,56,21,108,192,40,169,129,29,154,60,177,27,43,127,96,171,141,98,114,64,79,179,47,88,5,186,199,83,153,166,24,150,10,185,62,120,197,168,17,48,63];295;False
1993;8270;10263;[91,88,75,182,1,117,2,129,135,14,99,73,140,178,192,10,123,17,8,94,173,18,158,120,24,197,15,9,150,49,67,189,194,65,124,147,130,22,38,105,72,154,60,151,7,153,187,127,39,107,76,122,102,114,101,27,30,134,137,86,181,82,23,12,54,142,121,168,3,98,93,110,81,52,174,118,183,83,26,79,185,148,167,61,59,36,46,5,41,133,96,157,138,45,188,87,66,126,143,21,50,53,51,29,146,156,160,71,69,190,43,128,85,164,111,159,40,37,145,139,33,13,172,195,25,109,141,35,6,56,92,106,78,171,152,57,186,113,196,89,162,198,28,74,4,97,131,0,199,62,44,34,108,20,55,155,184,161,80,58,177,169,191,11,104,180,163,170,95,31,90,125,149,32,68,63,100,116,175,165,193,16,136,144,70,19,64,103,112,84,77,115,179,176,42,47,132,166,119,48];296;False
3020;7128;10148;[20,138,12,22,26,8,176,3,2,130,84,117,77,132,193,109,66,157,103,105,194,188,93,87,6,149,167,61,45,94,41,49,78,128,42,57,37,121,162,126,143,160,91,1,33,124,180,196,36,182,92,178,147,23,189,81,0,85,104,31,74,140,9,144,170,95,38,139,19,46,51,50,34,118,146,123,82,67,32,72,163,25,70,65,16,190,11,113,156,71,165,184,174,191,173,18,131,110,101,59,80,100,30,134,148,195,97,58,175,151,7,102,181,68,198,142,137,158,54,52,119,187,39,107,55,14,13,111,112,89,75,4,15,135,53,183,69,159,164,90,28,155,73,99,106,136,115,152,35,161,172,86,133,76,122,116,44,125,145,56,21,108,192,40,169,129,29,154,60,177,27,43,127,96,171,141,98,114,64,79,179,47,88,5,186,199,83,153,166,24,150,10,185,62,120,197,168,17,48,63];297;False
2061;8239;10300;[91,89,75,182,1,117,2,129,135,14,99,73,140,178,192,10,123,17,8,94,173,18,158,120,24,197,15,9,150,49,67,189,194,65,124,147,130,22,38,105,72,154,60,151,7,153,187,127,39,107,76,122,102,114,101,27,30,134,137,86,181,82,23,12,54,142,121,168,3,98,93,110,81,52,174,118,183,83,26,79,185,148,167,61,59,36,46,5,41,133,96,157,138,45,188,87,66,126,143,21,50,53,51,29,146,156,160,71,69,190,43,128,85,164,111,159,40,37,145,139,33,13,172,195,25,109,141,35,6,56,92,106,78,171,152,57,186,113,196,88,162,198,28,74,4,97,131,0,199,62,44,34,108,20,55,155,184,161,80,58,177,169,191,11,104,180,163,170,95,31,90,125,149,32,68,63,100,116,175,165,193,16,136,144,70,19,64,103,112,84,77,115,179,176,42,47,132,166,119,48];298;False
3133;7124;10257;[140,138,12,22,26,8,176,3,2,130,84,117,77,132,193,109,66,157,103,105,194,188,93,87,6,149,167,61,45,94,41,49,78,128,42,57,37,121,162,126,143,160,91,1,33,124,180,196,36,182,92,178,147,23,189,81,0,85,104,31,74,20,9,144,170,95,38,139,19,46,51,50,34,118,146,123,82,67,32,72,163,25,70,65,16,190,11,113,156,71,165,184,174,191,173,18,131,110,101,59,80,100,30,134,148,195,97,58,175,151,7,102,181,68,198,142,137,158,54,52,119,187,39,107,55,14,13,111,112,89,75,4,15,135,53,183,69,159,164,90,28,155,73,99,106,136,115,152,35,161,172,86,133,76,122,116,44,125,145,56,21,108,192,40,169,129,29,154,60,177,27,43,127,96,171,141,98,114,64,79,179,47,88,5,186,199,83,153,166,24,150,10,185,62,120,197,168,17,48,63];299;False
2051;8238;10289;[106,89,75,182,1,117,2,129,135,14,99,73,140,178,192,10,123,17,8,94,173,18,158,120,24,197,15,9,150,49,67,189,194,65,124,147,130,22,38,105,72,154,60,151,7,153,187,127,39,107,76,122,102,114,101,27,30,134,137,86,181,82,23,12,54,142,121,168,3,98,93,110,81,52,174,118,183,83,26,79,185,148,167,61,59,36,46,5,41,133,96,157,138,45,188,87,66,126,143,21,50,53,51,29,146,156,160,71,69,190,43,128,85,164,111,159,40,37,145,139,33,13,172,195,25,109,141,35,6,56,92,91,78,171,152,57,186,113,196,88,162,198,28,74,4,97,131,0,199,62,44,34,108,20,55,155,184,161,80,58,177,169,191,11,104,180,163,170,95,31,90,125,149,32,68,63,100,116,175,165,193,16,136,144,70,19,64,103,112,84,77,115,179,176,42,47,132,166,119,48];300;False
3128;7109;10237;[92,138,12,22,26,8,176,3,2,130,84,117,77,132,193,109,66,157,103,105,194,188,93,87,6,149,167,61,45,94,41,49,78,128,42,57,37,121,162,126,143,160,91,1,33,124,180,196,36,182,140,178,147,23,189,81,0,85,104,31,74,20,9,144,170,95,38,139,19,46,51,50,34,118,146,123,82,67,32,72,163,25,70,65,16,190,11,113,156,71,165,184,174,191,173,18,131,110,101,59,80,100,30,134,148,195,97,58,175,151,7,102,181,68,198,142,137,158,54,52,119,187,39,107,55,14,13,111,112,89,75,4,15,135,53,183,69,159,164,90,28,155,73,99,106,136,115,152,35,161,172,86,133,76,122,116,44,125,145,56,21,108,192,40,169,129,29,154,60,177,27,43,127,96,171,141,98,114,64,79,179,47,88,5,186,199,83,153,166,24,150,10,185,62,120,197,168,17,48,63];301;False
2055;8229;10284;[174,89,75,182,1,117,2,129,135,14,99,73,140,178,192,10,123,17,8,94,173,18,158,120,24,197,15,9,150,49,67,189,194,65,124,147,130,22,38,105,72,154,60,151,7,153,187,127,39,107,76,122,102,114,101,27,30,134,137,86,181,82,23,12,54,142,121,168,3,98,93,110,81,52,106,118,183,83,26,79,185,148,167,61,59,36,46,5,41,133,96,157,138,45,188,87,66,126,143,21,50,53,51,29,146,156,160,71,69,190,43,128,85,164,111,159,40,37,145,139,33,13,172,195,25,109,141,35,6,56,92,91,78,171,152,57,186,113,196,88,162,198,28,74,4,97,131,0,199,62,44,34,108,20,55,155,184,161,80,58,177,169,191,11,104,180,163,170,95,31,90,125,149,32,68,63,100,116,175,165,193,16,136,144,70,19,64,103,112,84,77,115,179,176,42,47,132,166,119,48];302;False
3103;7125;10228;[194,138,12,22,26,8,176,3,2,130,84,117,77,132,193,109,66,157,103,105,92,188,93,87,6,149,167,61,45,94,41,49,78,128,42,57,37,121,162,126,143,160,91,1,33,124,180,196,36,182,140,178,147,23,189,81,0,85,104,31,74,20,9,144,170,95,38,139,19,46,51,50,34,118,146,123,82,67,32,72,163,25,70,65,16,190,11,113,156,71,165,184,174,191,173,18,131,110,101,59,80,100,30,134,148,195,97,58,175,151,7,102,181,68,198,142,137,158,54,52,119,187,39,107,55,14,13,111,112,89,75,4,15,135,53,183,69,159,164,90,28,155,73,99,106,136,115,152,35,161,172,86,133,76,122,116,44,125,145,56,21,108,192,40,169,129,29,154,60,177,27,43,127,96,171,141,98,114,64,79,179,47,88,5,186,199,83,153,166,24,150,10,185,62,120,197,168,17,48,63];303;False
1994;8256;10250;[174,88,75,182,1,117,2,129,135,14,99,73,140,178,192,10,123,17,8,94,173,18,158,120,24,197,15,9,150,49,67,189,194,65,124,147,130,22,38,105,72,154,60,151,7,153,187,127,39,107,76,122,102,114,101,27,30,134,137,86,181,82,23,12,54,142,121,168,3,98,93,110,81,52,106,118,183,83,26,79,185,148,167,61,59,36,46,5,41,133,96,157,138,45,188,87,66,126,143,21,50,53,51,29,146,156,160,71,69,190,43,128,85,164,111,159,40,37,145,139,33,13,172,195,25,109,141,35,6,56,92,91,78,171,152,57,186,113,196,89,162,198,28,74,4,97,131,0,199,62,44,34,108,20,55,155,184,161,80,58,177,169,191,11,104,180,163,170,95,31,90,125,149,32,68,63,100,116,175,165,193,16,136,144,70,19,64,103,112,84,77,115,179,176,42,47,132,166,119,48];304;False
3044;7119;10163;[194,8,12,22,26,138,176,3,2,130,84,117,77,132,193,109,66,157,103,105,92,188,93,87,6,149,167,61,45,94,41,49,78,128,42,57,37,121,162,126,143,160,91,1,33,124,180,196,36,182,140,178,147,23,189,81,0,85,104,31,74,20,9,144,170,95,38,139,19,46,51,50,34,118,146,123,82,67,32,72,163,25,70,65,16,190,11,113,156,71,165,184,174,191,173,18,131,110,101,59,80,100,30,134,148,195,97,58,175,151,7,102,181,68,198,142,137,158,54,52,119,187,39,107,55,14,13,111,112,89,75,4,15,135,53,183,69,159,164,90,28,155,73,99,106,136,115,152,35,161,172,86,133,76,122,116,44,125,145,56,21,108,192,40,169,129,29,154,60,177,27,43,127,96,171,141,98,114,64,79,179,47,88,5,186,199,83,153,166,24,150,10,185,62,120,197,168,17,48,63];305;False
1952;8271;10223;[146,88,75,182,1,117,2,129,135,14,99,73,140,178,192,10,123,17,8,94,173,18,158,120,24,197,15,9,150,49,67,189,194,65,124,147,130,22,38,105,72,154,60,151,7,153,187,127,39,107,76,122,102,114,101,27,30,134,137,86,181,82,23,12,54,142,121,168,3,98,93,110,81,52,106,118,183,83,26,79,185,148,167,61,59,36,46,5,41,133,96,157,138,45,188,87,66,126,143,21,50,53,51,29,174,156,160,71,69,190,43,128,85,164,111,159,40,37,145,139,33,13,172,195,25,109,141,35,6,56,92,91,78,171,152,57,186,113,196,89,162,198,28,74,4,97,131,0,199,62,44,34,108,20,55,155,184,161,80,58,177,169,191,11,104,180,163,170,95,31,90,125,149,32,68,63,100,116,175,165,193,16,136,144,70,19,64,103,112,84,77,115,179,176,42,47,132,166,119,48];306;False
3020;7107;10127;[92,8,12,22,26,138,176,3,2,130,84,117,77,132,193,109,66,157,103,105,194,188,93,87,6,149,167,61,45,94,41,49,78,128,42,57,37,121,162,126,143,160,91,1,33,124,180,196,36,182,140,178,147,23,189,81,0,85,104,31,74,20,9,144,170,95,38,139,19,46,51,50,34,118,146,123,82,67,32,72,163,25,70,65,16,190,11,113,156,71,165,184,174,191,173,18,131,110,101,59,80,100,30,134,148,195,97,58,175,151,7,102,181,68,198,142,137,158,54,52,119,187,39,107,55,14,13,111,112,89,75,4,15,135,53,183,69,159,164,90,28,155,73,99,106,136,115,152,35,161,172,86,133,76,122,116,44,125,145,56,21,108,192,40,169,129,29,154,60,177,27,43,127,96,171,141,98,114,64,79,179,47,88,5,186,199,83,153,166,24,150,10,185,62,120,197,168,17,48,63];307;True
2028;8246;10274;[143,88,75,182,1,117,2,129,135,14,99,73,140,178,192,10,123,17,8,94,173,18,158,120,24,197,15,9,150,49,67,189,194,65,124,147,130,22,38,105,72,154,60,151,7,153,187,127,39,107,76,122,102,114,101,27,30,134,137,86,181,82,23,12,54,142,121,168,3,98,93,110,81,52,106,118,183,83,26,79,185,148,167,61,59,36,46,5,41,133,96,157,138,45,188,87,66,126,146,21,50,53,51,29,174,156,160,71,69,190,43,128,85,164,111,159,40,37,145,139,33,13,172,195,25,109,141,35,6,56,92,91,78,171,152,57,186,113,196,89,162,198,28,74,4,97,131,0,199,62,44,34,108,20,55,155,184,161,80,58,177,169,191,11,104,180,163,170,95,31,90,125,149,32,68,63,100,116,175,165,193,16,136,144,70,19,64,103,112,84,77,115,179,176,42,47,132,166,119,48];308;False
2975;7131;10106;[174,8,12,22,26,138,176,3,2,130,84,117,77,132,193,109,66,157,103,105,194,188,93,87,6,149,167,61,45,94,41,49,78,128,42,57,37,121,162,126,143,160,91,1,33,124,180,196,36,182,140,178,147,23,189,81,0,85,104,31,74,20,9,144,170,95,38,139,19,46,51,50,34,118,146,123,82,67,32,72,163,25,70,65,16,190,11,113,156,71,165,184,92,191,173,18,131,110,101,59,80,100,30,134,148,195,97,58,175,151,7,102,181,68,198,142,137,158,54,52,119,187,39,107,55,14,13,111,112,89,75,4,15,135,53,183,69,159,164,90,28,155,73,99,106,136,115,152,35,161,172,86,133,76,122,116,44,125,145,56,21,108,192,40,169,129,29,154,60,177,27,43,127,96,171,141,98,114,64,79,179,47,88,5,186,199,83,153,166,24,150,10,185,62,120,197,168,17,48,63];309;False
1980;8238;10218;[174,88,75,182,1,117,2,129,135,14,99,73,140,178,192,10,123,17,8,94,173,18,158,120,24,197,15,9,150,49,67,189,194,65,124,147,130,22,38,105,72,154,60,151,7,153,187,127,39,107,76,122,102,114,101,27,30,134,137,86,181,82,23,12,54,142,121,168,3,98,93,110,81,52,106,118,183,83,26,79,185,148,167,61,59,36,46,5,41,133,96,157,138,45,188,87,66,126,146,21,50,53,51,29,143,156,160,71,69,190,43,128,85,164,111,159,40,37,145,139,33,13,172,195,25,109,141,35,6,56,92,91,78,171,152,57,186,113,196,89,162,198,28,74,4,97,131,0,199,62,44,34,108,20,55,155,184,161,80,58,177,169,191,11,104,180,163,170,95,31,90,125,149,32,68,63,100,116,175,165,193,16,136,144,70,19,64,103,112,84,77,115,179,176,42,47,132,166,119,48];310;False
2949;7126;10075;[194,8,12,22,26,138,176,3,2,130,84,117,77,132,193,109,66,157,103,105,174,188,93,87,6,149,167,61,45,94,41,49,78,128,42,57,37,121,162,126,143,160,91,1,33,124,180,196,36,182,140,178,147,23,189,81,0,85,104,31,74,20,9,144,170,95,38,139,19,46,51,50,34,118,146,123,82,67,32,72,163,25,70,65,16,190,11,113,156,71,165,184,92,191,173,18,131,110,101,59,80,100,30,134,148,195,97,58,175,151,7,102,181,68,198,142,137,158,54,52,119,187,39,107,55,14,13,111,112,89,75,4,15,135,53,183,69,159,164,90,28,155,73,99,106,136,115,152,35,161,172,86,133,76,122,116,44,125,145,56,21,108,192,40,169,129,29,154,60,177,27,43,127,96,171,141,98,114,64,79,179,47,88,5,186,199,83,153,166,24,150,10,185,62,120,197,168,17,48,63];311;True
1947;8289;10236;[129,88,75,182,1,117,2,174,135,14,99,73,140,178,192,10,123,17,8,94,173,18,158,120,24,197,15,9,150,49,67,189,194,65,124,147,130,22,38,105,72,154,60,151,7,153,187,127,39,107,76,122,102,114,101,27,30,134,137,86,181,82,23,12,54,142,121,168,3,98,93,110,81,52,106,118,183,83,26,79,185,148,167,61,59,36,46,5,41,133,96,157,138,45,188,87,66,126,146,21,50,53,51,29,143,156,160,71,69,190,43,128,85,164,111,159,40,37,145,139,33,13,172,195,25,109,141,35,6,56,92,91,78,171,152,57,186,113,196,89,162,198,28,74,4,97,131,0,199,62,44,34,108,20,55,155,184,161,80,58,177,169,191,11,104,180,163,170,95,31,90,125,149,32,68,63,100,116,175,165,193,16,136,144,70,19,64,103,112,84,77,115,179,176,42,47,132,166,119,48];312;False
2942;7131;10073;[92,8,12,22,26,138,176,3,2,130,84,117,77,132,193,109,66,157,103,105,174,188,93,87,6,149,167,61,45,94,41,49,78,128,42,57,37,121,162,126,143,160,91,1,33,124,180,196,36,182,140,178,147,23,189,81,0,85,104,31,74,20,9,144,170,95,38,139,19,46,51,50,34,118,146,123,82,67,32,72,163,25,70,65,16,190,11,113,156,71,165,184,194,191,173,18,131,110,101,59,80,100,30,134,148,195,97,58,175,151,7,102,181,68,198,142,137,158,54,52,119,187,39,107,55,14,13,111,112,89,75,4,15,135,53,183,69,159,164,90,28,155,73,99,106,136,115,152,35,161,172,86,133,76,122,116,44,125,145,56,21,108,192,40,169,129,29,154,60,177,27,43,127,96,171,141,98,114,64,79,179,47,88,5,186,199,83,153,166,24,150,10,185,62,120,197,168,17,48,63];313;True
1941;8270;10211;[120,88,75,182,1,117,2,174,135,14,99,73,140,178,192,10,123,17,8,94,173,18,158,129,24,197,15,9,150,49,67,189,194,65,124,147,130,22,38,105,72,154,60,151,7,153,187,127,39,107,76,122,102,114,101,27,30,134,137,86,181,82,23,12,54,142,121,168,3,98,93,110,81,52,106,118,183,83,26,79,185,148,167,61,59,36,46,5,41,133,96,157,138,45,188,87,66,126,146,21,50,53,51,29,143,156,160,71,69,190,43,128,85,164,111,159,40,37,145,139,33,13,172,195,25,109,141,35,6,56,92,91,78,171,152,57,186,113,196,89,162,198,28,74,4,97,131,0,199,62,44,34,108,20,55,155,184,161,80,58,177,169,191,11,104,180,163,170,95,31,90,125,149,32,68,63,100,116,175,165,193,16,136,144,70,19,64,103,112,84,77,115,179,176,42,47,132,166,119,48];314;False
3005;7119;10124;[21,8,12,22,26,138,176,3,2,130,84,117,77,132,193,109,66,157,103,105,174,188,93,87,6,149,167,61,45,94,41,49,78,128,42,57,37,121,162,126,143,160,91,1,33,124,180,196,36,182,140,178,147,23,189,81,0,85,104,31,74,20,9,144,170,95,38,139,19,46,51,50,34,118,146,123,82,67,32,72,163,25,70,65,16,190,11,113,156,71,165,184,194,191,173,18,131,110,101,59,80,100,30,134,148,195,97,58,175,151,7,102,181,68,198,142,137,158,54,52,119,187,39,107,55,14,13,111,112,89,75,4,15,135,53,183,69,159,164,90,28,155,73,99,106,136,115,152,35,161,172,86,133,76,122,116,44,125,145,56,92,108,192,40,169,129,29,154,60,177,27,43,127,96,171,141,98,114,64,79,179,47,88,5,186,199,83,153,166,24,150,10,185,62,120,197,168,17,48,63];315;True
1921;8270;10191;[182,88,75,120,1,117,2,174,135,14,99,73,140,178,192,10,123,17,8,94,173,18,158,129,24,197,15,9,150,49,67,189,194,65,124,147,130,22,38,105,72,154,60,151,7,153,187,127,39,107,76,122,102,114,101,27,30,134,137,86,181,82,23,12,54,142,121,168,3,98,93,110,81,52,106,118,183,83,26,79,185,148,167,61,59,36,46,5,41,133,96,157,138,45,188,87,66,126,146,21,50,53,51,29,143,156,160,71,69,190,43,128,85,164,111,159,40,37,145,139,33,13,172,195,25,109,141,35,6,56,92,91,78,171,152,57,186,113,196,89,162,198,28,74,4,97,131,0,199,62,44,34,108,20,55,155,184,161,80,58,177,169,191,11,104,180,163,170,95,31,90,125,149,32,68,63,100,116,175,165,193,16,136,144,70,19,64,103,112,84,77,115,179,176,42,47,132,166,119,48];316;False
3011;7116;10127;[50,8,12,22,26,138,176,3,2,130,84,117,77,132,193,109,66,157,103,105,174,188,93,87,6,149,167,61,45,94,41,49,78,128,42,57,37,121,162,126,143,160,91,1,33,124,180,196,36,182,140,178,147,23,189,81,0,85,104,31,74,20,9,144,170,95,38,139,19,46,51,21,34,118,146,123,82,67,32,72,163,25,70,65,16,190,11,113,156,71,165,184,194,191,173,18,131,110,101,59,80,100,30,134,148,195,97,58,175,151,7,102,181,68,198,142,137,158,54,52,119,187,39,107,55,14,13,111,112,89,75,4,15,135,53,183,69,159,164,90,28,155,73,99,106,136,115,152,35,161,172,86,133,76,122,116,44,125,145,56,92,108,192,40,169,129,29,154,60,177,27,43,127,96,171,141,98,114,64,79,179,47,88,5,186,199,83,153,166,24,150,10,185,62,120,197,168,17,48,63];317;True
2054;8222;10276;[174,88,75,120,1,117,2,182,135,14,99,73,140,178,192,10,123,17,8,94,173,18,158,129,24,197,15,9,150,49,67,189,194,65,124,147,130,22,38,105,72,154,60,151,7,153,187,127,39,107,76,122,102,114,101,27,30,134,137,86,181,82,23,12,54,142,121,168,3,98,93,110,81,52,106,118,183,83,26,79,185,148,167,61,59,36,46,5,41,133,96,157,138,45,188,87,66,126,146,21,50,53,51,29,143,156,160,71,69,190,43,128,85,164,111,159,40,37,145,139,33,13,172,195,25,109,141,35,6,56,92,91,78,171,152,57,186,113,196,89,162,198,28,74,4,97,131,0,199,62,44,34,108,20,55,155,184,161,80,58,177,169,191,11,104,180,163,170,95,31,90,125,149,32,68,63,100,116,175,165,193,16,136,144,70,19,64,103,112,84,77,115,179,176,42,47,132,166,119,48];318;False
3227;7102;10329;[50,165,12,22,26,138,176,3,2,130,84,117,77,132,193,109,66,157,103,105,174,188,93,87,6,149,167,61,45,94,41,49,78,128,42,57,37,121,162,126,143,160,91,1,33,124,180,196,36,182,140,178,147,23,189,81,0,85,104,31,74,20,9,144,170,95,38,139,19,46,51,21,34,118,146,123,82,67,32,72,163,25,70,65,16,190,11,113,156,71,8,184,194,191,173,18,131,110,101,59,80,100,30,134,148,195,97,58,175,151,7,102,181,68,198,142,137,158,54,52,119,187,39,107,55,14,13,111,112,89,75,4,15,135,53,183,69,159,164,90,28,155,73,99,106,136,115,152,35,161,172,86,133,76,122,116,44,125,145,56,92,108,192,40,169,129,29,154,60,177,27,43,127,96,171,141,98,114,64,79,179,47,88,5,186,199,83,153,166,24,150,10,185,62,120,197,168,17,48,63];319;False
1974;8213;10187;[174,182,75,120,1,117,2,88,135,14,99,73,140,178,192,10,123,17,8,94,173,18,158,129,24,197,15,9,150,49,67,189,194,65,124,147,130,22,38,105,72,154,60,151,7,153,187,127,39,107,76,122,102,114,101,27,30,134,137,86,181,82,23,12,54,142,121,168,3,98,93,110,81,52,106,118,183,83,26,79,185,148,167,61,59,36,46,5,41,133,96,157,138,45,188,87,66,126,146,21,50,53,51,29,143,156,160,71,69,190,43,128,85,164,111,159,40,37,145,139,33,13,172,195,25,109,141,35,6,56,92,91,78,171,152,57,186,113,196,89,162,198,28,74,4,97,131,0,199,62,44,34,108,20,55,155,184,161,80,58,177,169,191,11,104,180,163,170,95,31,90,125,149,32,68,63,100,116,175,165,193,16,136,144,70,19,64,103,112,84,77,115,179,176,42,47,132,166,119,48];320;False
3371;7101;10472;[174,165,12,22,26,138,176,3,2,130,84,117,77,132,193,109,66,157,103,105,50,188,93,87,6,149,167,61,45,94,41,49,78,128,42,57,37,121,162,126,143,160,91,1,33,124,180,196,36,182,140,178,147,23,189,81,0,85,104,31,74,20,9,144,170,95,38,139,19,46,51,21,34,118,146,123,82,67,32,72,163,25,70,65,16,190,11,113,156,71,8,184,194,191,173,18,131,110,101,59,80,100,30,134,148,195,97,58,175,151,7,102,181,68,198,142,137,158,54,52,119,187,39,107,55,14,13,111,112,89,75,4,15,135,53,183,69,159,164,90,28,155,73,99,106,136,115,152,35,161,172,86,133,76,122,116,44,125,145,56,92,108,192,40,169,129,29,154,60,177,27,43,127,96,171,141,98,114,64,79,179,47,88,5,186,199,83,153,166,24,150,10,185,62,120,197,168,17,48,63];321;False
2060;8211;10271;[20,182,75,120,1,117,2,88,135,14,99,73,140,178,192,10,123,17,8,94,173,18,158,129,24,197,15,9,150,49,67,189,194,65,124,147,130,22,38,105,72,154,60,151,7,153,187,127,39,107,76,122,102,114,101,27,30,134,137,86,181,82,23,12,54,142,121,168,3,98,93,110,81,52,106,118,183,83,26,79,185,148,167,61,59,36,46,5,41,133,96,157,138,45,188,87,66,126,146,21,50,53,51,29,143,156,160,71,69,190,43,128,85,164,111,159,40,37,145,139,33,13,172,195,25,109,141,35,6,56,92,91,78,171,152,57,186,113,196,89,162,198,28,74,4,97,131,0,199,62,44,34,108,174,55,155,184,161,80,58,177,169,191,11,104,180,163,170,95,31,90,125,149,32,68,63,100,116,175,165,193,16,136,144,70,19,64,103,112,84,77,115,179,176,42,47,132,166,119,48];322;False
3338;7091;10429;[194,165,12,22,26,138,176,3,2,130,84,117,77,132,193,109,66,157,103,105,50,188,93,87,6,149,167,61,45,94,41,49,78,128,42,57,37,121,162,126,143,160,91,1,33,124,180,196,36,182,140,178,147,23,189,81,0,85,104,31,74,20,9,144,170,95,38,139,19,46,51,21,34,118,146,123,82,67,32,72,163,25,70,65,16,190,11,113,156,71,8,184,174,191,173,18,131,110,101,59,80,100,30,134,148,195,97,58,175,151,7,102,181,68,198,142,137,158,54,52,119,187,39,107,55,14,13,111,112,89,75,4,15,135,53,183,69,159,164,90,28,155,73,99,106,136,115,152,35,161,172,86,133,76,122,116,44,125,145,56,92,108,192,40,169,129,29,154,60,177,27,43,127,96,171,141,98,114,64,79,179,47,88,5,186,199,83,153,166,24,150,10,185,62,120,197,168,17,48,63];323;False
2082;8203;10285;[6,182,75,120,1,117,2,88,135,14,99,73,140,178,192,10,123,17,8,94,173,18,158,129,24,197,15,9,150,49,67,189,194,65,124,147,130,22,38,105,72,154,60,151,7,153,187,127,39,107,76,122,102,114,101,27,30,134,137,86,181,82,23,12,54,142,121,168,3,98,93,110,81,52,106,118,183,83,26,79,185,148,167,61,59,36,46,5,41,133,96,157,138,45,188,87,66,126,146,21,50,53,51,29,143,156,160,71,69,190,43,128,85,164,111,159,40,37,145,139,33,13,172,195,25,109,141,35,20,56,92,91,78,171,152,57,186,113,196,89,162,198,28,74,4,97,131,0,199,62,44,34,108,174,55,155,184,161,80,58,177,169,191,11,104,180,163,170,95,31,90,125,149,32,68,63,100,116,175,165,193,16,136,144,70,19,64,103,112,84,77,115,179,176,42,47,132,166,119,48];324;False
3305;7078;10383;[50,165,12,22,26,138,176,3,2,130,84,117,77,132,193,109,66,157,103,105,194,188,93,87,6,149,167,61,45,94,41,49,78,128,42,57,37,121,162,126,143,160,91,1,33,124,180,196,36,182,140,178,147,23,189,81,0,85,104,31,74,20,9,144,170,95,38,139,19,46,51,21,34,118,146,123,82,67,32,72,163,25,70,65,16,190,11,113,156,71,8,184,174,191,173,18,131,110,101,59,80,100,30,134,148,195,97,58,175,151,7,102,181,68,198,142,137,158,54,52,119,187,39,107,55,14,13,111,112,89,75,4,15,135,53,183,69,159,164,90,28,155,73,99,106,136,115,152,35,161,172,86,133,76,122,116,44,125,145,56,92,108,192,40,169,129,29,154,60,177,27,43,127,96,171,141,98,114,64,79,179,47,88,5,186,199,83,153,166,24,150,10,185,62,120,197,168,17,48,63];325;False
2028;8201;10229;[174,182,75,120,1,117,2,88,135,14,99,73,140,178,192,10,123,17,8,94,173,18,158,129,24,197,15,9,150,49,67,189,194,65,124,147,130,22,38,105,72,154,60,151,7,153,187,127,39,107,76,122,102,114,101,27,30,134,137,86,181,82,23,12,54,142,121,168,3,98,93,110,81,52,106,118,183,83,26,79,185,148,167,61,59,36,46,5,41,133,96,157,138,45,188,87,66,126,146,21,50,53,51,29,143,156,160,71,69,190,43,128,85,164,111,159,40,37,145,139,33,13,172,195,25,109,141,35,20,56,92,91,78,171,152,57,186,113,196,89,162,198,28,74,4,97,131,0,199,62,44,34,108,6,55,155,184,161,80,58,177,169,191,11,104,180,163,170,95,31,90,125,149,32,68,63,100,116,175,165,193,16,136,144,70,19,64,103,112,84,77,115,179,176,42,47,132,166,119,48];326;False
3172;7106;10278;[94,165,12,22,26,138,176,3,2,130,84,117,77,132,193,109,66,157,103,105,194,188,93,87,6,149,167,61,45,50,41,49,78,128,42,57,37,121,162,126,143,160,91,1,33,124,180,196,36,182,140,178,147,23,189,81,0,85,104,31,74,20,9,144,170,95,38,139,19,46,51,21,34,118,146,123,82,67,32,72,163,25,70,65,16,190,11,113,156,71,8,184,174,191,173,18,131,110,101,59,80,100,30,134,148,195,97,58,175,151,7,102,181,68,198,142,137,158,54,52,119,187,39,107,55,14,13,111,112,89,75,4,15,135,53,183,69,159,164,90,28,155,73,99,106,136,115,152,35,161,172,86,133,76,122,116,44,125,145,56,92,108,192,40,169,129,29,154,60,177,27,43,127,96,171,141,98,114,64,79,179,47,88,5,186,199,83,153,166,24,150,10,185,62,120,197,168,17,48,63];327;False
2061;8181;10242;[174,67,75,120,1,117,2,88,135,14,99,73,140,178,192,10,123,17,8,94,173,18,158,129,24,197,15,9,150,49,182,189,194,65,124,147,130,22,38,105,72,154,60,151,7,153,187,127,39,107,76,122,102,114,101,27,30,134,137,86,181,82,23,12,54,142,121,168,3,98,93,110,81,52,106,118,183,83,26,79,185,148,167,61,59,36,46,5,41,133,96,157,138,45,188,87,66,126,146,21,50,53,51,29,143,156,160,71,69,190,43,128,85,164,111,159,40,37,145,139,33,13,172,195,25,109,141,35,20,56,92,91,78,171,152,57,186,113,196,89,162,198,28,74,4,97,131,0,199,62,44,34,108,6,55,155,184,161,80,58,177,169,191,11,104,180,163,170,95,31,90,125,149,32,68,63,100,116,175,165,193,16,136,144,70,19,64,103,112,84,77,115,179,176,42,47,132,166,119,48];328;False
3197;7092;10289;[180,165,12,22,26,138,176,3,2,130,84,117,77,132,193,109,66,157,103,105,194,188,93,87,6,149,167,61,45,50,41,49,78,128,42,57,37,121,162,126,143,160,91,1,33,124,94,196,36,182,140,178,147,23,189,81,0,85,104,31,74,20,9,144,170,95,38,139,19,46,51,21,34,118,146,123,82,67,32,72,163,25,70,65,16,190,11,113,156,71,8,184,174,191,173,18,131,110,101,59,80,100,30,134,148,195,97,58,175,151,7,102,181,68,198,142,137,158,54,52,119,187,39,107,55,14,13,111,112,89,75,4,15,135,53,183,69,159,164,90,28,155,73,99,106,136,115,152,35,161,172,86,133,76,122,116,44,125,145,56,92,108,192,40,169,129,29,154,60,177,27,43,127,96,171,141,98,114,64,79,179,47,88,5,186,199,83,153,166,24,150,10,185,62,120,197,168,17,48,63];329;False
2046;8196;10242;[174,67,60,120,1,117,2,88,135,14,99,73,140,178,192,10,123,17,8,94,173,18,158,129,24,197,15,9,150,49,182,189,194,65,124,147,130,22,38,105,72,154,75,151,7,153,187,127,39,107,76,122,102,114,101,27,30,134,137,86,181,82,23,12,54,142,121,168,3,98,93,110,81,52,106,118,183,83,26,79,185,148,167,61,59,36,46,5,41,133,96,157,138,45,188,87,66,126,146,21,50,53,51,29,143,156,160,71,69,190,43,128,85,164,111,159,40,37,145,139,33,13,172,195,25,109,141,35,20,56,92,91,78,171,152,57,186,113,196,89,162,198,28,74,4,97,131,0,199,62,44,34,108,6,55,155,184,161,80,58,177,169,191,11,104,180,163,170,95,31,90,125,149,32,68,63,100,116,175,165,193,16,136,144,70,19,64,103,112,84,77,115,179,176,42,47,132,166,119,48];330;False
3231;7083;10314;[50,165,12,22,26,138,176,3,2,130,84,117,77,132,193,109,66,157,103,105,194,188,93,87,6,149,167,61,45,180,41,49,78,128,42,57,37,121,162,126,143,160,91,1,33,124,94,196,36,182,140,178,147,23,189,81,0,85,104,31,74,20,9,144,170,95,38,139,19,46,51,21,34,118,146,123,82,67,32,72,163,25,70,65,16,190,11,113,156,71,8,184,174,191,173,18,131,110,101,59,80,100,30,134,148,195,97,58,175,151,7,102,181,68,198,142,137,158,54,52,119,187,39,107,55,14,13,111,112,89,75,4,15,135,53,183,69,159,164,90,28,155,73,99,106,136,115,152,35,161,172,86,133,76,122,116,44,125,145,56,92,108,192,40,169,129,29,154,60,177,27,43,127,96,171,141,98,114,64,79,179,47,88,5,186,199,83,153,166,24,150,10,185,62,120,197,168,17,48,63];331;False
2085;8129;10214;[174,67,176,120,1,117,2,88,135,14,99,73,140,178,192,10,123,17,8,94,173,18,158,129,24,197,15,9,150,49,182,189,194,65,124,147,130,22,38,105,72,154,75,151,7,153,187,127,39,107,76,122,102,114,101,27,30,134,137,86,181,82,23,12,54,142,121,168,3,98,93,110,81,52,106,118,183,83,26,79,185,148,167,61,59,36,46,5,41,133,96,157,138,45,188,87,66,126,146,21,50,53,51,29,143,156,160,71,69,190,43,128,85,164,111,159,40,37,145,139,33,13,172,195,25,109,141,35,20,56,92,91,78,171,152,57,186,113,196,89,162,198,28,74,4,97,131,0,199,62,44,34,108,6,55,155,184,161,80,58,177,169,191,11,104,180,163,170,95,31,90,125,149,32,68,63,100,116,175,165,193,16,136,144,70,19,64,103,112,84,77,115,179,60,42,47,132,166,119,48];332;False
3136;7086;10222;[21,165,12,22,26,138,176,3,2,130,84,117,77,132,193,109,66,157,103,105,194,188,93,87,6,149,167,61,45,180,41,49,78,128,42,57,37,121,162,126,143,160,91,1,33,124,94,196,36,182,140,178,147,23,189,81,0,85,104,31,74,20,9,144,170,95,38,139,19,46,51,50,34,118,146,123,82,67,32,72,163,25,70,65,16,190,11,113,156,71,8,184,174,191,173,18,131,110,101,59,80,100,30,134,148,195,97,58,175,151,7,102,181,68,198,142,137,158,54,52,119,187,39,107,55,14,13,111,112,89,75,4,15,135,53,183,69,159,164,90,28,155,73,99,106,136,115,152,35,161,172,86,133,76,122,116,44,125,145,56,92,108,192,40,169,129,29,154,60,177,27,43,127,96,171,141,98,114,64,79,179,47,88,5,186,199,83,153,166,24,150,10,185,62,120,197,168,17,48,63];333;False
2060;8167;10227;[20,67,176,120,1,117,2,88,135,14,99,73,140,178,192,10,123,17,8,94,173,18,158,129,24,197,15,9,150,49,182,189,194,65,124,147,130,22,38,105,72,154,75,151,7,153,187,127,39,107,76,122,102,114,101,27,30,134,137,86,181,82,23,12,54,142,121,168,3,98,93,110,81,52,106,118,183,83,26,79,185,148,167,61,59,36,46,5,41,133,96,157,138,45,188,87,66,126,146,21,50,53,51,29,143,156,160,71,69,190,43,128,85,164,111,159,40,37,145,139,33,13,172,195,25,109,141,35,174,56,92,91,78,171,152,57,186,113,196,89,162,198,28,74,4,97,131,0,199,62,44,34,108,6,55,155,184,161,80,58,177,169,191,11,104,180,163,170,95,31,90,125,149,32,68,63,100,116,175,165,193,16,136,144,70,19,64,103,112,84,77,115,179,60,42,47,132,166,119,48];334;False
3057;7105;10162;[45,165,12,22,26,138,176,3,2,130,84,117,77,132,193,109,66,157,103,105,194,188,93,87,6,149,167,61,21,180,41,49,78,128,42,57,37,121,162,126,143,160,91,1,33,124,94,196,36,182,140,178,147,23,189,81,0,85,104,31,74,20,9,144,170,95,38,139,19,46,51,50,34,118,146,123,82,67,32,72,163,25,70,65,16,190,11,113,156,71,8,184,174,191,173,18,131,110,101,59,80,100,30,134,148,195,97,58,175,151,7,102,181,68,198,142,137,158,54,52,119,187,39,107,55,14,13,111,112,89,75,4,15,135,53,183,69,159,164,90,28,155,73,99,106,136,115,152,35,161,172,86,133,76,122,116,44,125,145,56,92,108,192,40,169,129,29,154,60,177,27,43,127,96,171,141,98,114,64,79,179,47,88,5,186,199,83,153,166,24,150,10,185,62,120,197,168,17,48,63];335;False
2057;8171;10228;[146,67,176,120,1,117,2,88,135,14,99,73,140,178,192,10,123,17,8,94,173,18,158,129,24,197,15,9,150,49,182,189,194,65,124,147,130,22,38,105,72,154,75,151,7,153,187,127,39,107,76,122,102,114,101,27,30,134,137,86,181,82,23,12,54,142,121,168,3,98,93,110,81,52,106,118,183,83,26,79,185,148,167,61,59,36,46,5,41,133,96,157,138,45,188,87,66,126,20,21,50,53,51,29,143,156,160,71,69,190,43,128,85,164,111,159,40,37,145,139,33,13,172,195,25,109,141,35,174,56,92,91,78,171,152,57,186,113,196,89,162,198,28,74,4,97,131,0,199,62,44,34,108,6,55,155,184,161,80,58,177,169,191,11,104,180,163,170,95,31,90,125,149,32,68,63,100,116,175,165,193,16,136,144,70,19,64,103,112,84,77,115,179,60,42,47,132,166,119,48];336;False
3034;7082;10116;[194,165,12,22,26,138,176,3,2,130,84,117,77,132,193,109,66,157,103,105,45,188,93,87,6,149,167,61,21,180,41,49,78,128,42,57,37,121,162,126,143,160,91,1,33,124,94,196,36,182,140,178,147,23,189,81,0,85,104,31,74,20,9,144,170,95,38,139,19,46,51,50,34,118,146,123,82,67,32,72,163,25,70,65,16,190,11,113,156,71,8,184,174,191,173,18,131,110,101,59,80,100,30,134,148,195,97,58,175,151,7,102,181,68,198,142,137,158,54,52,119,187,39,107,55,14,13,111,112,89,75,4,15,135,53,183,69,159,164,90,28,155,73,99,106,136,115,152,35,161,172,86,133,76,122,116,44,125,145,56,92,108,192,40,169,129,29,154,60,177,27,43,127,96,171,141,98,114,64,79,179,47,88,5,186,199,83,153,166,24,150,10,185,62,120,197,168,17,48,63];337;True
2004;8175;10179;[21,67,176,120,1,117,2,88,135,14,99,73,140,178,192,10,123,17,8,94,173,18,158,129,24,197,15,9,150,49,182,189,194,65,124,147,130,22,38,105,72,154,75,151,7,153,187,127,39,107,76,122,102,114,101,27,30,134,137,86,181,82,23,12,54,142,121,168,3,98,93,110,81,52,106,118,183,83,26,79,185,148,167,61,59,36,46,5,41,133,96,157,138,45,188,87,66,126,20,146,50,53,51,29,143,156,160,71,69,190,43,128,85,164,111,159,40,37,145,139,33,13,172,195,25,109,141,35,174,56,92,91,78,171,152,57,186,113,196,89,162,198,28,74,4,97,131,0,199,62,44,34,108,6,55,155,184,161,80,58,177,169,191,11,104,180,163,170,95,31,90,125,149,32,68,63,100,116,175,165,193,16,136,144,70,19,64,103,112,84,77,115,179,60,42,47,132,166,119,48];338;False
3160;7081;10241;[21,165,12,22,26,138,176,3,2,130,84,117,77,132,193,109,66,157,103,105,45,188,93,87,6,149,167,61,194,180,41,49,78,128,42,57,37,121,162,126,143,160,91,1,33,124,94,196,36,182,140,178,147,23,189,81,0,85,104,31,74,20,9,144,170,95,38,139,19,46,51,50,34,118,146,123,82,67,32,72,163,25,70,65,16,190,11,113,156,71,8,184,174,191,173,18,131,110,101,59,80,100,30,134,148,195,97,58,175,151,7,102,181,68,198,142,137,158,54,52,119,187,39,107,55,14,13,111,112,89,75,4,15,135,53,183,69,159,164,90,28,155,73,99,106,136,115,152,35,161,172,86,133,76,122,116,44,125,145,56,92,108,192,40,169,129,29,154,60,177,27,43,127,96,171,141,98,114,64,79,179,47,88,5,186,199,83,153,166,24,150,10,185,62,120,197,168,17,48,63];339;False
2035;8174;10209;[53,67,176,120,1,117,2,88,135,14,99,73,140,178,192,10,123,17,8,94,173,18,158,129,24,197,15,9,150,49,182,189,194,65,124,147,130,22,38,105,72,154,75,151,7,153,187,127,39,107,76,122,102,114,101,27,30,134,137,86,181,82,23,12,54,142,121,168,3,98,93,110,81,52,106,118,183,83,26,79,185,148,167,61,59,36,46,5,41,133,96,157,138,45,188,87,66,126,20,146,50,21,51,29,143,156,160,71,69,190,43,128,85,164,111,159,40,37,145,139,33,13,172,195,25,109,141,35,174,56,92,91,78,171,152,57,186,113,196,89,162,198,28,74,4,97,131,0,199,62,44,34,108,6,55,155,184,161,80,58,177,169,191,11,104,180,163,170,95,31,90,125,149,32,68,63,100,116,175,165,193,16,136,144,70,19,64,103,112,84,77,115,179,60,42,47,132,166,119,48];340;False
3205;7074;10279;[180,165,12,22,26,138,176,3,2,130,84,117,77,132,193,109,66,157,103,105,45,188,93,87,6,149,167,61,194,21,41,49,78,128,42,57,37,121,162,126,143,160,91,1,33,124,94,196,36,182,140,178,147,23,189,81,0,85,104,31,74,20,9,144,170,95,38,139,19,46,51,50,34,118,146,123,82,67,32,72,163,25,70,65,16,190,11,113,156,71,8,184,174,191,173,18,131,110,101,59,80,100,30,134,148,195,97,58,175,151,7,102,181,68,198,142,137,158,54,52,119,187,39,107,55,14,13,111,112,89,75,4,15,135,53,183,69,159,164,90,28,155,73,99,106,136,115,152,35,161,172,86,133,76,122,116,44,125,145,56,92,108,192,40,169,129,29,154,60,177,27,43,127,96,171,141,98,114,64,79,179,47,88,5,186,199,83,153,166,24,150,10,185,62,120,197,168,17,48,63];341;False
2084;8161;10245;[90,67,176,120,1,117,2,88,135,14,99,73,140,178,192,10,123,17,8,94,173,18,158,129,24,197,15,9,150,49,182,189,194,65,124,147,130,22,38,105,72,154,75,151,7,153,187,127,39,107,76,122,102,114,101,27,30,134,137,86,181,82,23,12,54,142,121,168,3,98,93,110,81,52,106,118,183,83,26,79,185,148,167,61,59,36,46,5,41,133,96,157,138,45,188,87,66,126,20,146,50,21,51,29,143,156,160,71,69,190,43,128,85,164,111,159,40,37,145,139,33,13,172,195,25,109,141,35,174,56,92,91,78,171,152,57,186,113,196,89,162,198,28,74,4,97,131,0,199,62,44,34,108,6,55,155,184,161,80,58,177,169,191,11,104,180,163,170,95,31,53,125,149,32,68,63,100,116,175,165,193,16,136,144,70,19,64,103,112,84,77,115,179,60,42,47,132,166,119,48];342;False
3134;7074;10208;[34,165,12,22,26,138,176,3,2,130,84,117,77,132,193,109,66,157,103,105,45,188,93,87,6,149,167,61,194,21,41,49,78,128,42,57,37,121,162,126,143,160,91,1,33,124,94,196,36,182,140,178,147,23,189,81,0,85,104,31,74,20,9,144,170,95,38,139,19,46,51,50,180,118,146,123,82,67,32,72,163,25,70,65,16,190,11,113,156,71,8,184,174,191,173,18,131,110,101,59,80,100,30,134,148,195,97,58,175,151,7,102,181,68,198,142,137,158,54,52,119,187,39,107,55,14,13,111,112,89,75,4,15,135,53,183,69,159,164,90,28,155,73,99,106,136,115,152,35,161,172,86,133,76,122,116,44,125,145,56,92,108,192,40,169,129,29,154,60,177,27,43,127,96,171,141,98,114,64,79,179,47,88,5,186,199,83,153,166,24,150,10,185,62,120,197,168,17,48,63];343;True
2074;8164;10238;[90,67,165,120,1,117,2,88,135,14,99,73,140,178,192,10,123,17,8,94,173,18,158,129,24,197,15,9,150,49,182,189,194,65,124,147,130,22,38,105,72,154,75,151,7,153,187,127,39,107,76,122,102,114,101,27,30,134,137,86,181,82,23,12,54,142,121,168,3,98,93,110,81,52,106,118,183,83,26,79,185,148,167,61,59,36,46,5,41,133,96,157,138,45,188,87,66,126,20,146,50,21,51,29,143,156,160,71,69,190,43,128,85,164,111,159,40,37,145,139,33,13,172,195,25,109,141,35,174,56,92,91,78,171,152,57,186,113,196,89,162,198,28,74,4,97,131,0,199,62,44,34,108,6,55,155,184,161,80,58,177,169,191,11,104,180,163,170,95,31,53,125,149,32,68,63,100,116,175,176,193,16,136,144,70,19,64,103,112,84,77,115,179,60,42,47,132,166,119,48];344;False
3330;7071;10401;[198,165,12,22,26,138,176,3,2,130,84,117,77,132,193,109,66,157,103,105,45,188,93,87,6,149,167,61,194,21,41,49,78,128,42,57,37,121,162,126,143,160,91,1,33,124,94,196,36,182,140,178,147,23,189,81,0,85,104,31,74,20,9,144,170,95,38,139,19,46,51,50,180,118,146,123,82,67,32,72,163,25,70,65,16,190,11,113,156,71,8,184,174,191,173,18,131,110,101,59,80,100,30,134,148,195,97,58,175,151,7,102,181,68,34,142,137,158,54,52,119,187,39,107,55,14,13,111,112,89,75,4,15,135,53,183,69,159,164,90,28,155,73,99,106,136,115,152,35,161,172,86,133,76,122,116,44,125,145,56,92,108,192,40,169,129,29,154,60,177,27,43,127,96,171,141,98,114,64,79,179,47,88,5,186,199,83,153,166,24,150,10,185,62,120,197,168,17,48,63];345;False
2054;8159;10213;[90,67,166,120,1,117,2,88,135,14,99,73,140,178,192,10,123,17,8,94,173,18,158,129,24,197,15,9,150,49,182,189,194,65,124,147,130,22,38,105,72,154,75,151,7,153,187,127,39,107,76,122,102,114,101,27,30,134,137,86,181,82,23,12,54,142,121,168,3,98,93,110,81,52,106,118,183,83,26,79,185,148,167,61,59,36,46,5,41,133,96,157,138,45,188,87,66,126,20,146,50,21,51,29,143,156,160,71,69,190,43,128,85,164,111,159,40,37,145,139,33,13,172,195,25,109,141,35,174,56,92,91,78,171,152,57,186,113,196,89,162,198,28,74,4,97,131,0,199,62,44,34,108,6,55,155,184,161,80,58,177,169,191,11,104,180,163,170,95,31,53,125,149,32,68,63,100,116,175,176,193,16,136,144,70,19,64,103,112,84,77,115,179,60,42,47,132,165,119,48];346;False
3217;7073;10290;[194,165,12,22,26,138,176,3,2,130,84,117,77,132,193,109,66,157,103,105,45,188,93,87,6,149,167,61,198,21,41,49,78,128,42,57,37,121,162,126,143,160,91,1,33,124,94,196,36,182,140,178,147,23,189,81,0,85,104,31,74,20,9,144,170,95,38,139,19,46,51,50,180,118,146,123,82,67,32,72,163,25,70,65,16,190,11,113,156,71,8,184,174,191,173,18,131,110,101,59,80,100,30,134,148,195,97,58,175,151,7,102,181,68,34,142,137,158,54,52,119,187,39,107,55,14,13,111,112,89,75,4,15,135,53,183,69,159,164,90,28,155,73,99,106,136,115,152,35,161,172,86,133,76,122,116,44,125,145,56,92,108,192,40,169,129,29,154,60,177,27,43,127,96,171,141,98,114,64,79,179,47,88,5,186,199,83,153,166,24,150,10,185,62,120,197,168,17,48,63];347;True
2005;8172;10177;[53,67,166,120,1,117,2,88,135,14,99,73,140,178,192,10,123,17,8,94,173,18,158,129,24,197,15,9,150,49,182,189,194,65,124,147,130,22,38,105,72,154,75,151,7,153,187,127,39,107,76,122,102,114,101,27,30,134,137,86,181,82,23,12,54,142,121,168,3,98,93,110,81,52,106,118,183,83,26,79,185,148,167,61,59,36,46,5,41,133,96,157,138,45,188,87,66,126,20,146,50,21,51,29,143,156,160,71,69,190,43,128,85,164,111,159,40,37,145,139,33,13,172,195,25,109,141,35,174,56,92,91,78,171,152,57,186,113,196,89,162,198,28,74,4,97,131,0,199,62,44,34,108,6,55,155,184,161,80,58,177,169,191,11,104,180,163,170,95,31,90,125,149,32,68,63,100,116,175,176,193,16,136,144,70,19,64,103,112,84,77,115,179,60,42,47,132,165,119,48];348;False
3237;7067;10304;[194,19,12,22,26,138,176,3,2,130,84,117,77,132,193,109,66,157,103,105,45,188,93,87,6,149,167,61,198,21,41,49,78,128,42,57,37,121,162,126,143,160,91,1,33,124,94,196,36,182,140,178,147,23,189,81,0,85,104,31,74,20,9,144,170,95,38,139,165,46,51,50,180,118,146,123,82,67,32,72,163,25,70,65,16,190,11,113,156,71,8,184,174,191,173,18,131,110,101,59,80,100,30,134,148,195,97,58,175,151,7,102,181,68,34,142,137,158,54,52,119,187,39,107,55,14,13,111,112,89,75,4,15,135,53,183,69,159,164,90,28,155,73,99,106,136,115,152,35,161,172,86,133,76,122,116,44,125,145,56,92,108,192,40,169,129,29,154,60,177,27,43,127,96,171,141,98,114,64,79,179,47,88,5,186,199,83,153,166,24,150,10,185,62,120,197,168,17,48,63];349;True
1974;8173;10147;[21,67,166,120,1,117,2,88,135,14,99,73,140,178,192,10,123,17,8,94,173,18,158,129,24,197,15,9,150,49,182,189,194,65,124,147,130,22,38,105,72,154,75,151,7,153,187,127,39,107,76,122,102,114,101,27,30,134,137,86,181,82,23,12,54,142,121,168,3,98,93,110,81,52,106,118,183,83,26,79,185,148,167,61,59,36,46,5,41,133,96,157,138,45,188,87,66,126,20,146,50,53,51,29,143,156,160,71,69,190,43,128,85,164,111,159,40,37,145,139,33,13,172,195,25,109,141,35,174,56,92,91,78,171,152,57,186,113,196,89,162,198,28,74,4,97,131,0,199,62,44,34,108,6,55,155,184,161,80,58,177,169,191,11,104,180,163,170,95,31,90,125,149,32,68,63,100,116,175,176,193,16,136,144,70,19,64,103,112,84,77,115,179,60,42,47,132,165,119,48];350;False
3283;7064;10347;[198,19,12,22,26,138,176,3,2,130,84,117,77,132,193,109,66,157,103,105,45,188,93,87,6,149,167,61,194,21,41,49,78,128,42,57,37,121,162,126,143,160,91,1,33,124,94,196,36,182,140,178,147,23,189,81,0,85,104,31,74,20,9,144,170,95,38,139,165,46,51,50,180,118,146,123,82,67,32,72,163,25,70,65,16,190,11,113,156,71,8,184,174,191,173,18,131,110,101,59,80,100,30,134,148,195,97,58,175,151,7,102,181,68,34,142,137,158,54,52,119,187,39,107,55,14,13,111,112,89,75,4,15,135,53,183,69,159,164,90,28,155,73,99,106,136,115,152,35,161,172,86,133,76,122,116,44,125,145,56,92,108,192,40,169,129,29,154,60,177,27,43,127,96,171,141,98,114,64,79,179,47,88,5,186,199,83,153,166,24,150,10,185,62,120,197,168,17,48,63];351;False
2073;8158;10231;[14,67,166,120,1,117,2,88,135,21,99,73,140,178,192,10,123,17,8,94,173,18,158,129,24,197,15,9,150,49,182,189,194,65,124,147,130,22,38,105,72,154,75,151,7,153,187,127,39,107,76,122,102,114,101,27,30,134,137,86,181,82,23,12,54,142,121,168,3,98,93,110,81,52,106,118,183,83,26,79,185,148,167,61,59,36,46,5,41,133,96,157,138,45,188,87,66,126,20,146,50,53,51,29,143,156,160,71,69,190,43,128,85,164,111,159,40,37,145,139,33,13,172,195,25,109,141,35,174,56,92,91,78,171,152,57,186,113,196,89,162,198,28,74,4,97,131,0,199,62,44,34,108,6,55,155,184,161,80,58,177,169,191,11,104,180,163,170,95,31,90,125,149,32,68,63,100,116,175,176,193,16,136,144,70,19,64,103,112,84,77,115,179,60,42,47,132,165,119,48];352;False
3390;7061;10451;[198,19,117,22,26,138,176,3,2,130,84,12,77,132,193,109,66,157,103,105,45,188,93,87,6,149,167,61,194,21,41,49,78,128,42,57,37,121,162,126,143,160,91,1,33,124,94,196,36,182,140,178,147,23,189,81,0,85,104,31,74,20,9,144,170,95,38,139,165,46,51,50,180,118,146,123,82,67,32,72,163,25,70,65,16,190,11,113,156,71,8,184,174,191,173,18,131,110,101,59,80,100,30,134,148,195,97,58,175,151,7,102,181,68,34,142,137,158,54,52,119,187,39,107,55,14,13,111,112,89,75,4,15,135,53,183,69,159,164,90,28,155,73,99,106,136,115,152,35,161,172,86,133,76,122,116,44,125,145,56,92,108,192,40,169,129,29,154,60,177,27,43,127,96,171,141,98,114,64,79,179,47,88,5,186,199,83,153,166,24,150,10,185,62,120,197,168,17,48,63];353;False
2024;8167;10191;[150,67,166,120,1,117,2,88,135,21,99,73,140,178,192,10,123,17,8,94,173,18,158,129,24,197,15,9,14,49,182,189,194,65,124,147,130,22,38,105,72,154,75,151,7,153,187,127,39,107,76,122,102,114,101,27,30,134,137,86,181,82,23,12,54,142,121,168,3,98,93,110,81,52,106,118,183,83,26,79,185,148,167,61,59,36,46,5,41,133,96,157,138,45,188,87,66,126,20,146,50,53,51,29,143,156,160,71,69,190,43,128,85,164,111,159,40,37,145,139,33,13,172,195,25,109,141,35,174,56,92,91,78,171,152,57,186,113,196,89,162,198,28,74,4,97,131,0,199,62,44,34,108,6,55,155,184,161,80,58,177,169,191,11,104,180,163,170,95,31,90,125,149,32,68,63,100,116,175,176,193,16,136,144,70,19,64,103,112,84,77,115,179,60,42,47,132,165,119,48];354;False
3548;7060;10608;[198,91,117,22,26,138,176,3,2,130,84,12,77,132,193,109,66,157,103,105,45,188,93,87,6,149,167,61,194,21,41,49,78,128,42,57,37,121,162,126,143,160,19,1,33,124,94,196,36,182,140,178,147,23,189,81,0,85,104,31,74,20,9,144,170,95,38,139,165,46,51,50,180,118,146,123,82,67,32,72,163,25,70,65,16,190,11,113,156,71,8,184,174,191,173,18,131,110,101,59,80,100,30,134,148,195,97,58,175,151,7,102,181,68,34,142,137,158,54,52,119,187,39,107,55,14,13,111,112,89,75,4,15,135,53,183,69,159,164,90,28,155,73,99,106,136,115,152,35,161,172,86,133,76,122,116,44,125,145,56,92,108,192,40,169,129,29,154,60,177,27,43,127,96,171,141,98,114,64,79,179,47,88,5,186,199,83,153,166,24,150,10,185,62,120,197,168,17,48,63];355;False
2018;8164;10182;[21,67,166,120,1,117,2,88,135,150,99,73,140,178,192,10,123,17,8,94,173,18,158,129,24,197,15,9,14,49,182,189,194,65,124,147,130,22,38,105,72,154,75,151,7,153,187,127,39,107,76,122,102,114,101,27,30,134,137,86,181,82,23,12,54,142,121,168,3,98,93,110,81,52,106,118,183,83,26,79,185,148,167,61,59,36,46,5,41,133,96,157,138,45,188,87,66,126,20,146,50,53,51,29,143,156,160,71,69,190,43,128,85,164,111,159,40,37,145,139,33,13,172,195,25,109,141,35,174,56,92,91,78,171,152,57,186,113,196,89,162,198,28,74,4,97,131,0,199,62,44,34,108,6,55,155,184,161,80,58,177,169,191,11,104,180,163,170,95,31,90,125,149,32,68,63,100,116,175,176,193,16,136,144,70,19,64,103,112,84,77,115,179,60,42,47,132,165,119,48];356;False
3640;7058;10698;[198,72,117,22,26,138,176,3,2,130,84,12,77,132,193,109,66,157,103,105,45,188,93,87,6,149,167,61,194,21,41,49,78,128,42,57,37,121,162,126,143,160,19,1,33,124,94,196,36,182,140,178,147,23,189,81,0,85,104,31,74,20,9,144,170,95,38,139,165,46,51,50,180,118,146,123,82,67,32,91,163,25,70,65,16,190,11,113,156,71,8,184,174,191,173,18,131,110,101,59,80,100,30,134,148,195,97,58,175,151,7,102,181,68,34,142,137,158,54,52,119,187,39,107,55,14,13,111,112,89,75,4,15,135,53,183,69,159,164,90,28,155,73,99,106,136,115,152,35,161,172,86,133,76,122,116,44,125,145,56,92,108,192,40,169,129,29,154,60,177,27,43,127,96,171,141,98,114,64,79,179,47,88,5,186,199,83,153,166,24,150,10,185,62,120,197,168,17,48,63];357;False
2049;8163;10212;[53,67,166,120,1,117,2,88,135,150,99,73,140,178,192,10,123,17,8,94,173,18,158,129,24,197,15,9,14,49,182,189,194,65,124,147,130,22,38,105,72,154,75,151,7,153,187,127,39,107,76,122,102,114,101,27,30,134,137,86,181,82,23,12,54,142,121,168,3,98,93,110,81,52,106,118,183,83,26,79,185,148,167,61,59,36,46,5,41,133,96,157,138,45,188,87,66,126,20,146,50,21,51,29,143,156,160,71,69,190,43,128,85,164,111,159,40,37,145,139,33,13,172,195,25,109,141,35,174,56,92,91,78,171,152,57,186,113,196,89,162,198,28,74,4,97,131,0,199,62,44,34,108,6,55,155,184,161,80,58,177,169,191,11,104,180,163,170,95,31,90,125,149,32,68,63,100,116,175,176,193,16,136,144,70,19,64,103,112,84,77,115,179,60,42,47,132,165,119,48];358;False
3466;7060;10526;[34,72,117,22,26,138,176,3,2,130,84,12,77,132,193,109,66,157,103,105,45,188,93,87,6,149,167,61,194,21,41,49,78,128,42,57,37,121,162,126,143,160,19,1,33,124,94,196,36,182,140,178,147,23,189,81,0,85,104,31,74,20,9,144,170,95,38,139,165,46,51,50,180,118,146,123,82,67,32,91,163,25,70,65,16,190,11,113,156,71,8,184,174,191,173,18,131,110,101,59,80,100,30,134,148,195,97,58,175,151,7,102,181,68,198,142,137,158,54,52,119,187,39,107,55,14,13,111,112,89,75,4,15,135,53,183,69,159,164,90,28,155,73,99,106,136,115,152,35,161,172,86,133,76,122,116,44,125,145,56,92,108,192,40,169,129,29,154,60,177,27,43,127,96,171,141,98,114,64,79,179,47,88,5,186,199,83,153,166,24,150,10,185,62,120,197,168,17,48,63];359;False
2053;8162;10215;[53,67,166,120,1,117,110,88,135,150,99,73,140,178,192,10,123,17,8,94,173,18,158,129,24,197,15,9,14,49,182,189,194,65,124,147,130,22,38,105,72,154,75,151,7,153,187,127,39,107,76,122,102,114,101,27,30,134,137,86,181,82,23,12,54,142,121,168,3,98,93,2,81,52,106,118,183,83,26,79,185,148,167,61,59,36,46,5,41,133,96,157,138,45,188,87,66,126,20,146,50,21,51,29,143,156,160,71,69,190,43,128,85,164,111,159,40,37,145,139,33,13,172,195,25,109,141,35,174,56,92,91,78,171,152,57,186,113,196,89,162,198,28,74,4,97,131,0,199,62,44,34,108,6,55,155,184,161,80,58,177,169,191,11,104,180,163,170,95,31,90,125,149,32,68,63,100,116,175,176,193,16,136,144,70,19,64,103,112,84,77,115,179,60,42,47,132,165,119,48];360;False
3496;7059;10555;[34,178,117,22,26,138,176,3,2,130,84,12,77,132,193,109,66,157,103,105,45,188,93,87,6,149,167,61,194,21,41,49,78,128,42,57,37,121,162,126,143,160,19,1,33,124,94,196,36,182,140,72,147,23,189,81,0,85,104,31,74,20,9,144,170,95,38,139,165,46,51,50,180,118,146,123,82,67,32,91,163,25,70,65,16,190,11,113,156,71,8,184,174,191,173,18,131,110,101,59,80,100,30,134,148,195,97,58,175,151,7,102,181,68,198,142,137,158,54,52,119,187,39,107,55,14,13,111,112,89,75,4,15,135,53,183,69,159,164,90,28,155,73,99,106,136,115,152,35,161,172,86,133,76,122,116,44,125,145,56,92,108,192,40,169,129,29,154,60,177,27,43,127,96,171,141,98,114,64,79,179,47,88,5,186,199,83,153,166,24,150,10,185,62,120,197,168,17,48,63];361;False
2022;8163;10185;[21,67,166,120,1,117,110,88,135,150,99,73,140,178,192,10,123,17,8,94,173,18,158,129,24,197,15,9,14,49,182,189,194,65,124,147,130,22,38,105,72,154,75,151,7,153,187,127,39,107,76,122,102,114,101,27,30,134,137,86,181,82,23,12,54,142,121,168,3,98,93,2,81,52,106,118,183,83,26,79,185,148,167,61,59,36,46,5,41,133,96,157,138,45,188,87,66,126,20,146,50,53,51,29,143,156,160,71,69,190,43,128,85,164,111,159,40,37,145,139,33,13,172,195,25,109,141,35,174,56,92,91,78,171,152,57,186,113,196,89,162,198,28,74,4,97,131,0,199,62,44,34,108,6,55,155,184,161,80,58,177,169,191,11,104,180,163,170,95,31,90,125,149,32,68,63,100,116,175,176,193,16,136,144,70,19,64,103,112,84,77,115,179,60,42,47,132,165,119,48];362;False
3580;7057;10637;[34,41,117,22,26,138,176,3,2,130,84,12,77,132,193,109,66,157,103,105,45,188,93,87,6,149,167,61,194,21,178,49,78,128,42,57,37,121,162,126,143,160,19,1,33,124,94,196,36,182,140,72,147,23,189,81,0,85,104,31,74,20,9,144,170,95,38,139,165,46,51,50,180,118,146,123,82,67,32,91,163,25,70,65,16,190,11,113,156,71,8,184,174,191,173,18,131,110,101,59,80,100,30,134,148,195,97,58,175,151,7,102,181,68,198,142,137,158,54,52,119,187,39,107,55,14,13,111,112,89,75,4,15,135,53,183,69,159,164,90,28,155,73,99,106,136,115,152,35,161,172,86,133,76,122,116,44,125,145,56,92,108,192,40,169,129,29,154,60,177,27,43,127,96,171,141,98,114,64,79,179,47,88,5,186,199,83,153,166,24,150,10,185,62,120,197,168,17,48,63];363;False
2038;8157;10195;[143,67,166,120,1,117,110,88,135,150,99,73,140,178,192,10,123,17,8,94,173,18,158,129,24,197,15,9,14,49,182,189,194,65,124,147,130,22,38,105,72,154,75,151,7,153,187,127,39,107,76,122,102,114,101,27,30,134,137,86,181,82,23,12,54,142,121,168,3,98,93,2,81,52,106,118,183,83,26,79,185,148,167,61,59,36,46,5,41,133,96,157,138,45,188,87,66,126,20,146,50,53,51,29,21,156,160,71,69,190,43,128,85,164,111,159,40,37,145,139,33,13,172,195,25,109,141,35,174,56,92,91,78,171,152,57,186,113,196,89,162,198,28,74,4,97,131,0,199,62,44,34,108,6,55,155,184,161,80,58,177,169,191,11,104,180,163,170,95,31,90,125,149,32,68,63,100,116,175,176,193,16,136,144,70,19,64,103,112,84,77,115,179,60,42,47,132,165,119,48];364;False
3697;7056;10753;[34,90,117,22,26,138,176,3,2,130,84,12,77,132,193,109,66,157,103,105,45,188,93,87,6,149,167,61,194,21,178,49,78,128,42,57,37,121,162,126,143,160,19,1,33,124,94,196,36,182,140,72,147,23,189,81,0,85,104,31,74,20,9,144,170,95,38,139,165,46,51,50,180,118,146,123,82,67,32,91,163,25,70,65,16,190,11,113,156,71,8,184,174,191,173,18,131,110,101,59,80,100,30,134,148,195,97,58,175,151,7,102,181,68,198,142,137,158,54,52,119,187,39,107,55,14,13,111,112,89,75,4,15,135,53,183,69,159,164,41,28,155,73,99,106,136,115,152,35,161,172,86,133,76,122,116,44,125,145,56,92,108,192,40,169,129,29,154,60,177,27,43,127,96,171,141,98,114,64,79,179,47,88,5,186,199,83,153,166,24,150,10,185,62,120,197,168,17,48,63];365;False
2028;8160;10188;[147,67,166,120,1,117,110,88,135,150,99,73,140,178,192,10,123,17,8,94,173,18,158,129,24,197,15,9,14,49,182,189,194,65,124,143,130,22,38,105,72,154,75,151,7,153,187,127,39,107,76,122,102,114,101,27,30,134,137,86,181,82,23,12,54,142,121,168,3,98,93,2,81,52,106,118,183,83,26,79,185,148,167,61,59,36,46,5,41,133,96,157,138,45,188,87,66,126,20,146,50,53,51,29,21,156,160,71,69,190,43,128,85,164,111,159,40,37,145,139,33,13,172,195,25,109,141,35,174,56,92,91,78,171,152,57,186,113,196,89,162,198,28,74,4,97,131,0,199,62,44,34,108,6,55,155,184,161,80,58,177,169,191,11,104,180,163,170,95,31,90,125,149,32,68,63,100,116,175,176,193,16,136,144,70,19,64,103,112,84,77,115,179,60,42,47,132,165,119,48];366;False
3794;7050;10844;[34,154,117,22,26,138,176,3,2,130,84,12,77,132,193,109,66,157,103,105,45,188,93,87,6,149,167,61,194,21,178,49,78,128,42,57,37,121,162,126,143,160,19,1,33,124,94,196,36,182,140,72,147,23,189,81,0,85,104,31,74,20,9,144,170,95,38,139,165,46,51,50,180,118,146,123,82,67,32,91,163,25,70,65,16,190,11,113,156,71,8,184,174,191,173,18,131,110,101,59,80,100,30,134,148,195,97,58,175,151,7,102,181,68,198,142,137,158,54,52,119,187,39,107,55,14,13,111,112,89,75,4,15,135,53,183,69,159,164,41,28,155,73,99,106,136,115,152,35,161,172,86,133,76,122,116,44,125,145,56,92,108,192,40,169,129,29,90,60,177,27,43,127,96,171,141,98,114,64,79,179,47,88,5,186,199,83,153,166,24,150,10,185,62,120,197,168,17,48,63];367;False
2082;8152;10234;[147,67,166,32,1,117,110,88,135,150,99,73,140,178,192,10,123,17,8,94,173,18,158,129,24,197,15,9,14,49,182,189,194,65,124,143,130,22,38,105,72,154,75,151,7,153,187,127,39,107,76,122,102,114,101,27,30,134,137,86,181,82,23,12,54,142,121,168,3,98,93,2,81,52,106,118,183,83,26,79,185,148,167,61,59,36,46,5,41,133,96,157,138,45,188,87,66,126,20,146,50,53,51,29,21,156,160,71,69,190,43,128,85,164,111,159,40,37,145,139,33,13,172,195,25,109,141,35,174,56,92,91,78,171,152,57,186,113,196,89,162,198,28,74,4,97,131,0,199,62,44,34,108,6,55,155,184,161,80,58,177,169,191,11,104,180,163,170,95,31,90,125,149,120,68,63,100,116,175,176,193,16,136,144,70,19,64,103,112,84,77,115,179,60,42,47,132,165,119,48];368;False
3673;7052;10725;[34,178,117,22,26,138,176,3,2,130,84,12,77,132,193,109,66,157,103,105,45,188,93,87,6,149,167,61,194,21,154,49,78,128,42,57,37,121,162,126,143,160,19,1,33,124,94,196,36,182,140,72,147,23,189,81,0,85,104,31,74,20,9,144,170,95,38,139,165,46,51,50,180,118,146,123,82,67,32,91,163,25,70,65,16,190,11,113,156,71,8,184,174,191,173,18,131,110,101,59,80,100,30,134,148,195,97,58,175,151,7,102,181,68,198,142,137,158,54,52,119,187,39,107,55,14,13,111,112,89,75,4,15,135,53,183,69,159,164,41,28,155,73,99,106,136,115,152,35,161,172,86,133,76,122,116,44,125,145,56,92,108,192,40,169,129,29,90,60,177,27,43,127,96,171,141,98,114,64,79,179,47,88,5,186,199,83,153,166,24,150,10,185,62,120,197,168,17,48,63];369;False
2053;8129;10182;[147,67,166,174,1,117,110,88,135,150,99,73,140,178,192,10,123,17,8,94,173,18,158,129,24,197,15,9,14,49,182,189,194,65,124,143,130,22,38,105,72,154,75,151,7,153,187,127,39,107,76,122,102,114,101,27,30,134,137,86,181,82,23,12,54,142,121,168,3,98,93,2,81,52,106,118,183,83,26,79,185,148,167,61,59,36,46,5,41,133,96,157,138,45,188,87,66,126,20,146,50,53,51,29,21,156,160,71,69,190,43,128,85,164,111,159,40,37,145,139,33,13,172,195,25,109,141,35,32,56,92,91,78,171,152,57,186,113,196,89,162,198,28,74,4,97,131,0,199,62,44,34,108,6,55,155,184,161,80,58,177,169,191,11,104,180,163,170,95,31,90,125,149,120,68,63,100,116,175,176,193,16,136,144,70,19,64,103,112,84,77,115,179,60,42,47,132,165,119,48];370;False
3643;7053;10696;[34,72,117,22,26,138,176,3,2,130,84,12,77,132,193,109,66,157,103,105,45,188,93,87,6,149,167,61,194,21,154,49,78,128,42,57,37,121,162,126,143,160,19,1,33,124,94,196,36,182,140,178,147,23,189,81,0,85,104,31,74,20,9,144,170,95,38,139,165,46,51,50,180,118,146,123,82,67,32,91,163,25,70,65,16,190,11,113,156,71,8,184,174,191,173,18,131,110,101,59,80,100,30,134,148,195,97,58,175,151,7,102,181,68,198,142,137,158,54,52,119,187,39,107,55,14,13,111,112,89,75,4,15,135,53,183,69,159,164,41,28,155,73,99,106,136,115,152,35,161,172,86,133,76,122,116,44,125,145,56,92,108,192,40,169,129,29,90,60,177,27,43,127,96,171,141,98,114,64,79,179,47,88,5,186,199,83,153,166,24,150,10,185,62,120,197,168,17,48,63];371;False
2063;8126;10189;[143,67,166,174,1,117,110,88,135,150,99,73,140,178,192,10,123,17,8,94,173,18,158,129,24,197,15,9,14,49,182,189,194,65,124,147,130,22,38,105,72,154,75,151,7,153,187,127,39,107,76,122,102,114,101,27,30,134,137,86,181,82,23,12,54,142,121,168,3,98,93,2,81,52,106,118,183,83,26,79,185,148,167,61,59,36,46,5,41,133,96,157,138,45,188,87,66,126,20,146,50,53,51,29,21,156,160,71,69,190,43,128,85,164,111,159,40,37,145,139,33,13,172,195,25,109,141,35,32,56,92,91,78,171,152,57,186,113,196,89,162,198,28,74,4,97,131,0,199,62,44,34,108,6,55,155,184,161,80,58,177,169,191,11,104,180,163,170,95,31,90,125,149,120,68,63,100,116,175,176,193,16,136,144,70,19,64,103,112,84,77,115,179,60,42,47,132,165,119,48];372;False
3755;7050;10805;[34,49,117,22,26,138,176,3,2,130,84,12,77,132,193,109,66,157,103,105,45,188,93,87,6,149,167,61,194,21,154,72,78,128,42,57,37,121,162,126,143,160,19,1,33,124,94,196,36,182,140,178,147,23,189,81,0,85,104,31,74,20,9,144,170,95,38,139,165,46,51,50,180,118,146,123,82,67,32,91,163,25,70,65,16,190,11,113,156,71,8,184,174,191,173,18,131,110,101,59,80,100,30,134,148,195,97,58,175,151,7,102,181,68,198,142,137,158,54,52,119,187,39,107,55,14,13,111,112,89,75,4,15,135,53,183,69,159,164,41,28,155,73,99,106,136,115,152,35,161,172,86,133,76,122,116,44,125,145,56,92,108,192,40,169,129,29,90,60,177,27,43,127,96,171,141,98,114,64,79,179,47,88,5,186,199,83,153,166,24,150,10,185,62,120,197,168,17,48,63];373;False
2047;8132;10179;[21,67,166,174,1,117,110,88,135,150,99,73,140,178,192,10,123,17,8,94,173,18,158,129,24,197,15,9,14,49,182,189,194,65,124,147,130,22,38,105,72,154,75,151,7,153,187,127,39,107,76,122,102,114,101,27,30,134,137,86,181,82,23,12,54,142,121,168,3,98,93,2,81,52,106,118,183,83,26,79,185,148,167,61,59,36,46,5,41,133,96,157,138,45,188,87,66,126,20,146,50,53,51,29,143,156,160,71,69,190,43,128,85,164,111,159,40,37,145,139,33,13,172,195,25,109,141,35,32,56,92,91,78,171,152,57,186,113,196,89,162,198,28,74,4,97,131,0,199,62,44,34,108,6,55,155,184,161,80,58,177,169,191,11,104,180,163,170,95,31,90,125,149,120,68,63,100,116,175,176,193,16,136,144,70,19,64,103,112,84,77,115,179,60,42,47,132,165,119,48];374;False
3734;7042;10776;[154,49,117,22,26,138,176,3,2,130,84,12,77,132,193,109,66,157,103,105,45,188,93,87,6,149,167,61,194,21,34,72,78,128,42,57,37,121,162,126,143,160,19,1,33,124,94,196,36,182,140,178,147,23,189,81,0,85,104,31,74,20,9,144,170,95,38,139,165,46,51,50,180,118,146,123,82,67,32,91,163,25,70,65,16,190,11,113,156,71,8,184,174,191,173,18,131,110,101,59,80,100,30,134,148,195,97,58,175,151,7,102,181,68,198,142,137,158,54,52,119,187,39,107,55,14,13,111,112,89,75,4,15,135,53,183,69,159,164,41,28,155,73,99,106,136,115,152,35,161,172,86,133,76,122,116,44,125,145,56,92,108,192,40,169,129,29,90,60,177,27,43,127,96,171,141,98,114,64,79,179,47,88,5,186,199,83,153,166,24,150,10,185,62,120,197,168,17,48,63];375;False
2075;8114;10189;[34,67,166,174,1,117,110,88,135,150,99,73,140,178,192,10,123,17,8,94,173,18,158,129,24,197,15,9,14,49,182,189,194,65,124,147,130,22,38,105,72,154,75,151,7,153,187,127,39,107,76,122,102,114,101,27,30,134,137,86,181,82,23,12,54,142,121,168,3,98,93,2,81,52,106,118,183,83,26,79,185,148,167,61,59,36,46,5,41,133,96,157,138,45,188,87,66,126,20,146,50,53,51,29,143,156,160,71,69,190,43,128,85,164,111,159,40,37,145,139,33,13,172,195,25,109,141,35,32,56,92,91,78,171,152,57,186,113,196,89,162,198,28,74,4,97,131,0,199,62,44,21,108,6,55,155,184,161,80,58,177,169,191,11,104,180,163,170,95,31,90,125,149,120,68,63,100,116,175,176,193,16,136,144,70,19,64,103,112,84,77,115,179,60,42,47,132,165,119,48];376;False
3815;7035;10850;[4,49,117,22,26,138,176,3,2,130,84,12,77,132,193,109,66,157,103,105,45,188,93,87,6,149,167,61,194,21,34,72,78,128,42,57,37,121,162,126,143,160,19,1,33,124,94,196,36,182,140,178,147,23,189,81,0,85,104,31,74,20,9,144,170,95,38,139,165,46,51,50,180,118,146,123,82,67,32,91,163,25,70,65,16,190,11,113,156,71,8,184,174,191,173,18,131,110,101,59,80,100,30,134,148,195,97,58,175,151,7,102,181,68,198,142,137,158,54,52,119,187,39,107,55,14,13,111,112,89,75,154,15,135,53,183,69,159,164,41,28,155,73,99,106,136,115,152,35,161,172,86,133,76,122,116,44,125,145,56,92,108,192,40,169,129,29,90,60,177,27,43,127,96,171,141,98,114,64,79,179,47,88,5,186,199,83,153,166,24,150,10,185,62,120,197,168,17,48,63];377;False
2086;8108;10194;[90,67,166,174,1,117,110,88,135,150,99,73,140,178,192,10,123,17,8,94,173,18,158,129,24,197,15,9,14,49,182,189,194,65,124,147,130,22,38,105,72,154,75,151,7,153,187,127,39,107,76,122,102,114,101,27,30,134,137,86,181,82,23,12,54,142,121,168,3,98,93,2,81,52,106,118,183,83,26,79,185,148,167,61,59,36,46,5,41,133,96,157,138,45,188,87,66,126,20,146,50,53,51,29,143,156,160,71,69,190,43,128,85,164,111,159,40,37,145,139,33,13,172,195,25,109,141,35,32,56,92,91,78,171,152,57,186,113,196,89,162,198,28,74,4,97,131,0,199,62,44,21,108,6,55,155,184,161,80,58,177,169,191,11,104,180,163,170,95,31,34,125,149,120,68,63,100,116,175,176,193,16,136,144,70,19,64,103,112,84,77,115,179,60,42,47,132,165,119,48];378;False
3807;7033;10840;[194,49,117,22,26,138,176,3,2,130,84,12,77,132,193,109,66,157,103,105,45,188,93,87,6,149,167,61,4,21,34,72,78,128,42,57,37,121,162,126,143,160,19,1,33,124,94,196,36,182,140,178,147,23,189,81,0,85,104,31,74,20,9,144,170,95,38,139,165,46,51,50,180,118,146,123,82,67,32,91,163,25,70,65,16,190,11,113,156,71,8,184,174,191,173,18,131,110,101,59,80,100,30,134,148,195,97,58,175,151,7,102,181,68,198,142,137,158,54,52,119,187,39,107,55,14,13,111,112,89,75,154,15,135,53,183,69,159,164,41,28,155,73,99,106,136,115,152,35,161,172,86,133,76,122,116,44,125,145,56,92,108,192,40,169,129,29,90,60,177,27,43,127,96,171,141,98,114,64,79,179,47,88,5,186,199,83,153,166,24,150,10,185,62,120,197,168,17,48,63];379;False
2059;8127;10186;[90,67,166,174,1,93,110,88,135,150,99,73,140,178,192,10,123,17,8,94,173,18,158,129,24,197,15,9,14,49,182,189,194,65,124,147,130,22,38,105,72,154,75,151,7,153,187,127,39,107,76,122,102,114,101,27,30,134,137,86,181,82,23,12,54,142,121,168,3,98,117,2,81,52,106,118,183,83,26,79,185,148,167,61,59,36,46,5,41,133,96,157,138,45,188,87,66,126,20,146,50,53,51,29,143,156,160,71,69,190,43,128,85,164,111,159,40,37,145,139,33,13,172,195,25,109,141,35,32,56,92,91,78,171,152,57,186,113,196,89,162,198,28,74,4,97,131,0,199,62,44,21,108,6,55,155,184,161,80,58,177,169,191,11,104,180,163,170,95,31,34,125,149,120,68,63,100,116,175,176,193,16,136,144,70,19,64,103,112,84,77,115,179,60,42,47,132,165,119,48];380;False
3787;7035;10822;[34,49,117,22,26,138,176,3,2,130,84,12,77,132,193,109,66,157,103,105,45,188,93,87,6,149,167,61,4,21,194,72,78,128,42,57,37,121,162,126,143,160,19,1,33,124,94,196,36,182,140,178,147,23,189,81,0,85,104,31,74,20,9,144,170,95,38,139,165,46,51,50,180,118,146,123,82,67,32,91,163,25,70,65,16,190,11,113,156,71,8,184,174,191,173,18,131,110,101,59,80,100,30,134,148,195,97,58,175,151,7,102,181,68,198,142,137,158,54,52,119,187,39,107,55,14,13,111,112,89,75,154,15,135,53,183,69,159,164,41,28,155,73,99,106,136,115,152,35,161,172,86,133,76,122,116,44,125,145,56,92,108,192,40,169,129,29,90,60,177,27,43,127,96,171,141,98,114,64,79,179,47,88,5,186,199,83,153,166,24,150,10,185,62,120,197,168,17,48,63];381;False
2046;8118;10164;[90,67,166,174,1,93,27,88,135,150,99,73,140,178,192,10,123,17,8,94,173,18,158,129,24,197,15,9,14,49,182,189,194,65,124,147,130,22,38,105,72,154,75,151,7,153,187,127,39,107,76,122,102,114,101,110,30,134,137,86,181,82,23,12,54,142,121,168,3,98,117,2,81,52,106,118,183,83,26,79,185,148,167,61,59,36,46,5,41,133,96,157,138,45,188,87,66,126,20,146,50,53,51,29,143,156,160,71,69,190,43,128,85,164,111,159,40,37,145,139,33,13,172,195,25,109,141,35,32,56,92,91,78,171,152,57,186,113,196,89,162,198,28,74,4,97,131,0,199,62,44,21,108,6,55,155,184,161,80,58,177,169,191,11,104,180,163,170,95,31,34,125,149,120,68,63,100,116,175,176,193,16,136,144,70,19,64,103,112,84,77,115,179,60,42,47,132,165,119,48];382;False
3840;7031;10871;[180,49,117,22,26,138,176,3,2,130,84,12,77,132,193,109,66,157,103,105,45,188,93,87,6,149,167,61,4,21,194,72,78,128,42,57,37,121,162,126,143,160,19,1,33,124,94,196,36,182,140,178,147,23,189,81,0,85,104,31,74,20,9,144,170,95,38,139,165,46,51,50,34,118,146,123,82,67,32,91,163,25,70,65,16,190,11,113,156,71,8,184,174,191,173,18,131,110,101,59,80,100,30,134,148,195,97,58,175,151,7,102,181,68,198,142,137,158,54,52,119,187,39,107,55,14,13,111,112,89,75,154,15,135,53,183,69,159,164,41,28,155,73,99,106,136,115,152,35,161,172,86,133,76,122,116,44,125,145,56,92,108,192,40,169,129,29,90,60,177,27,43,127,96,171,141,98,114,64,79,179,47,88,5,186,199,83,153,166,24,150,10,185,62,120,197,168,17,48,63];383;False
2035;8124;10159;[34,67,166,174,1,93,27,88,135,150,99,73,140,178,192,10,123,17,8,94,173,18,158,129,24,197,15,9,14,49,182,189,194,65,124,147,130,22,38,105,72,154,75,151,7,153,187,127,39,107,76,122,102,114,101,110,30,134,137,86,181,82,23,12,54,142,121,168,3,98,117,2,81,52,106,118,183,83,26,79,185,148,167,61,59,36,46,5,41,133,96,157,138,45,188,87,66,126,20,146,50,53,51,29,143,156,160,71,69,190,43,128,85,164,111,159,40,37,145,139,33,13,172,195,25,109,141,35,32,56,92,91,78,171,152,57,186,113,196,89,162,198,28,74,4,97,131,0,199,62,44,21,108,6,55,155,184,161,80,58,177,169,191,11,104,180,163,170,95,31,90,125,149,120,68,63,100,116,175,176,193,16,136,144,70,19,64,103,112,84,77,115,179,60,42,47,132,165,119,48];384;False
3803;7027;10830;[194,49,117,22,26,138,176,3,2,130,84,12,77,132,193,109,66,157,103,105,45,188,93,87,6,149,167,61,4,21,180,72,78,128,42,57,37,121,162,126,143,160,19,1,33,124,94,196,36,182,140,178,147,23,189,81,0,85,104,31,74,20,9,144,170,95,38,139,165,46,51,50,34,118,146,123,82,67,32,91,163,25,70,65,16,190,11,113,156,71,8,184,174,191,173,18,131,110,101,59,80,100,30,134,148,195,97,58,175,151,7,102,181,68,198,142,137,158,54,52,119,187,39,107,55,14,13,111,112,89,75,154,15,135,53,183,69,159,164,41,28,155,73,99,106,136,115,152,35,161,172,86,133,76,122,116,44,125,145,56,92,108,192,40,169,129,29,90,60,177,27,43,127,96,171,141,98,114,64,79,179,47,88,5,186,199,83,153,166,24,150,10,185,62,120,197,168,17,48,63];385;False
2007;8142;10149;[21,67,166,174,1,93,27,88,135,150,99,73,140,178,192,10,123,17,8,94,173,18,158,129,24,197,15,9,14,49,182,189,194,65,124,147,130,22,38,105,72,154,75,151,7,153,187,127,39,107,76,122,102,114,101,110,30,134,137,86,181,82,23,12,54,142,121,168,3,98,117,2,81,52,106,118,183,83,26,79,185,148,167,61,59,36,46,5,41,133,96,157,138,45,188,87,66,126,20,146,50,53,51,29,143,156,160,71,69,190,43,128,85,164,111,159,40,37,145,139,33,13,172,195,25,109,141,35,32,56,92,91,78,171,152,57,186,113,196,89,162,198,28,74,4,97,131,0,199,62,44,34,108,6,55,155,184,161,80,58,177,169,191,11,104,180,163,170,95,31,90,125,149,120,68,63,100,116,175,176,193,16,136,144,70,19,64,103,112,84,77,115,179,60,42,47,132,165,119,48];386;False
3800;7030;10830;[34,49,117,22,26,138,176,3,2,130,84,12,77,132,193,109,66,157,103,105,45,188,93,87,6,149,167,61,4,21,180,72,78,128,42,57,37,121,162,126,143,160,19,1,33,124,94,196,36,182,140,178,147,23,189,81,0,85,104,31,74,20,9,144,170,95,38,139,165,46,51,50,194,118,146,123,82,67,32,91,163,25,70,65,16,190,11,113,156,71,8,184,174,191,173,18,131,110,101,59,80,100,30,134,148,195,97,58,175,151,7,102,181,68,198,142,137,158,54,52,119,187,39,107,55,14,13,111,112,89,75,154,15,135,53,183,69,159,164,41,28,155,73,99,106,136,115,152,35,161,172,86,133,76,122,116,44,125,145,56,92,108,192,40,169,129,29,90,60,177,27,43,127,96,171,141,98,114,64,79,179,47,88,5,186,199,83,153,166,24,150,10,185,62,120,197,168,17,48,63];387;False
2023;8136;10159;[143,67,166,174,1,93,27,88,135,150,99,73,140,178,192,10,123,17,8,94,173,18,158,129,24,197,15,9,14,49,182,189,194,65,124,147,130,22,38,105,72,154,75,151,7,153,187,127,39,107,76,122,102,114,101,110,30,134,137,86,181,82,23,12,54,142,121,168,3,98,117,2,81,52,106,118,183,83,26,79,185,148,167,61,59,36,46,5,41,133,96,157,138,45,188,87,66,126,20,146,50,53,51,29,21,156,160,71,69,190,43,128,85,164,111,159,40,37,145,139,33,13,172,195,25,109,141,35,32,56,92,91,78,171,152,57,186,113,196,89,162,198,28,74,4,97,131,0,199,62,44,34,108,6,55,155,184,161,80,58,177,169,191,11,104,180,163,170,95,31,90,125,149,120,68,63,100,116,175,176,193,16,136,144,70,19,64,103,112,84,77,115,179,60,42,47,132,165,119,48];388;False
3872;7025;10897;[34,84,117,22,26,138,176,3,2,130,49,12,77,132,193,109,66,157,103,105,45,188,93,87,6,149,167,61,4,21,180,72,78,128,42,57,37,121,162,126,143,160,19,1,33,124,94,196,36,182,140,178,147,23,189,81,0,85,104,31,74,20,9,144,170,95,38,139,165,46,51,50,194,118,146,123,82,67,32,91,163,25,70,65,16,190,11,113,156,71,8,184,174,191,173,18,131,110,101,59,80,100,30,134,148,195,97,58,175,151,7,102,181,68,198,142,137,158,54,52,119,187,39,107,55,14,13,111,112,89,75,154,15,135,53,183,69,159,164,41,28,155,73,99,106,136,115,152,35,161,172,86,133,76,122,116,44,125,145,56,92,108,192,40,169,129,29,90,60,177,27,43,127,96,171,141,98,114,64,79,179,47,88,5,186,199,83,153,166,24,150,10,185,62,120,197,168,17,48,63];389;False
2013;8139;10152;[147,67,166,174,1,93,27,88,135,150,99,73,140,178,192,10,123,17,8,94,173,18,158,129,24,197,15,9,14,49,182,189,194,65,124,143,130,22,38,105,72,154,75,151,7,153,187,127,39,107,76,122,102,114,101,110,30,134,137,86,181,82,23,12,54,142,121,168,3,98,117,2,81,52,106,118,183,83,26,79,185,148,167,61,59,36,46,5,41,133,96,157,138,45,188,87,66,126,20,146,50,53,51,29,21,156,160,71,69,190,43,128,85,164,111,159,40,37,145,139,33,13,172,195,25,109,141,35,32,56,92,91,78,171,152,57,186,113,196,89,162,198,28,74,4,97,131,0,199,62,44,34,108,6,55,155,184,161,80,58,177,169,191,11,104,180,163,170,95,31,90,125,149,120,68,63,100,116,175,176,193,16,136,144,70,19,64,103,112,84,77,115,179,60,42,47,132,165,119,48];390;False
3858;7023;10881;[194,84,117,22,26,138,176,3,2,130,49,12,77,132,193,109,66,157,103,105,45,188,93,87,6,149,167,61,4,21,180,72,78,128,42,57,37,121,162,126,143,160,19,1,33,124,94,196,36,182,140,178,147,23,189,81,0,85,104,31,74,20,9,144,170,95,38,139,165,46,51,50,34,118,146,123,82,67,32,91,163,25,70,65,16,190,11,113,156,71,8,184,174,191,173,18,131,110,101,59,80,100,30,134,148,195,97,58,175,151,7,102,181,68,198,142,137,158,54,52,119,187,39,107,55,14,13,111,112,89,75,154,15,135,53,183,69,159,164,41,28,155,73,99,106,136,115,152,35,161,172,86,133,76,122,116,44,125,145,56,92,108,192,40,169,129,29,90,60,177,27,43,127,96,171,141,98,114,64,79,179,47,88,5,186,199,83,153,166,24,150,10,185,62,120,197,168,17,48,63];391;False
2082;8091;10173;[147,67,166,174,1,5,27,88,135,150,99,73,140,178,192,10,123,17,8,94,173,18,158,129,24,197,15,9,14,49,182,189,194,65,124,143,130,22,38,105,72,154,75,151,7,153,187,127,39,107,76,122,102,114,101,110,30,134,137,86,181,82,23,12,54,142,121,168,3,98,117,2,81,52,106,118,183,83,26,79,185,148,167,61,59,36,46,93,41,133,96,157,138,45,188,87,66,126,20,146,50,53,51,29,21,156,160,71,69,190,43,128,85,164,111,159,40,37,145,139,33,13,172,195,25,109,141,35,32,56,92,91,78,171,152,57,186,113,196,89,162,198,28,74,4,97,131,0,199,62,44,34,108,6,55,155,184,161,80,58,177,169,191,11,104,180,163,170,95,31,90,125,149,120,68,63,100,116,175,176,193,16,136,144,70,19,64,103,112,84,77,115,179,60,42,47,132,165,119,48];392;False
3865;7018;10883;[4,84,117,22,26,138,176,3,2,130,49,12,77,132,193,109,66,157,103,105,45,188,93,87,6,149,167,61,194,21,180,72,78,128,42,57,37,121,162,126,143,160,19,1,33,124,94,196,36,182,140,178,147,23,189,81,0,85,104,31,74,20,9,144,170,95,38,139,165,46,51,50,34,118,146,123,82,67,32,91,163,25,70,65,16,190,11,113,156,71,8,184,174,191,173,18,131,110,101,59,80,100,30,134,148,195,97,58,175,151,7,102,181,68,198,142,137,158,54,52,119,187,39,107,55,14,13,111,112,89,75,154,15,135,53,183,69,159,164,41,28,155,73,99,106,136,115,152,35,161,172,86,133,76,122,116,44,125,145,56,92,108,192,40,169,129,29,90,60,177,27,43,127,96,171,141,98,114,64,79,179,47,88,5,186,199,83,153,166,24,150,10,185,62,120,197,168,17,48,63];393;False
2092;8088;10180;[143,67,166,174,1,5,27,88,135,150,99,73,140,178,192,10,123,17,8,94,173,18,158,129,24,197,15,9,14,49,182,189,194,65,124,147,130,22,38,105,72,154,75,151,7,153,187,127,39,107,76,122,102,114,101,110,30,134,137,86,181,82,23,12,54,142,121,168,3,98,117,2,81,52,106,118,183,83,26,79,185,148,167,61,59,36,46,93,41,133,96,157,138,45,188,87,66,126,20,146,50,53,51,29,21,156,160,71,69,190,43,128,85,164,111,159,40,37,145,139,33,13,172,195,25,109,141,35,32,56,92,91,78,171,152,57,186,113,196,89,162,198,28,74,4,97,131,0,199,62,44,34,108,6,55,155,184,161,80,58,177,169,191,11,104,180,163,170,95,31,90,125,149,120,68,63,100,116,175,176,193,16,136,144,70,19,64,103,112,84,77,115,179,60,42,47,132,165,119,48];394;False
3904;7013;10917;[198,84,117,22,26,138,176,3,2,130,49,12,77,132,193,109,66,157,103,105,45,188,93,87,6,149,167,61,194,21,180,72,78,128,42,57,37,121,162,126,143,160,19,1,33,124,94,196,36,182,140,178,147,23,189,81,0,85,104,31,74,20,9,144,170,95,38,139,165,46,51,50,34,118,146,123,82,67,32,91,163,25,70,65,16,190,11,113,156,71,8,184,174,191,173,18,131,110,101,59,80,100,30,134,148,195,97,58,175,151,7,102,181,68,4,142,137,158,54,52,119,187,39,107,55,14,13,111,112,89,75,154,15,135,53,183,69,159,164,41,28,155,73,99,106,136,115,152,35,161,172,86,133,76,122,116,44,125,145,56,92,108,192,40,169,129,29,90,60,177,27,43,127,96,171,141,98,114,64,79,179,47,88,5,186,199,83,153,166,24,150,10,185,62,120,197,168,17,48,63];395;False
2076;8094;10170;[21,67,166,174,1,5,27,88,135,150,99,73,140,178,192,10,123,17,8,94,173,18,158,129,24,197,15,9,14,49,182,189,194,65,124,147,130,22,38,105,72,154,75,151,7,153,187,127,39,107,76,122,102,114,101,110,30,134,137,86,181,82,23,12,54,142,121,168,3,98,117,2,81,52,106,118,183,83,26,79,185,148,167,61,59,36,46,93,41,133,96,157,138,45,188,87,66,126,20,146,50,53,51,29,143,156,160,71,69,190,43,128,85,164,111,159,40,37,145,139,33,13,172,195,25,109,141,35,32,56,92,91,78,171,152,57,186,113,196,89,162,198,28,74,4,97,131,0,199,62,44,34,108,6,55,155,184,161,80,58,177,169,191,11,104,180,163,170,95,31,90,125,149,120,68,63,100,116,175,176,193,16,136,144,70,19,64,103,112,84,77,115,179,60,42,47,132,165,119,48];396;False
3855;7024;10879;[198,49,117,22,26,138,176,3,2,130,84,12,77,132,193,109,66,157,103,105,45,188,93,87,6,149,167,61,194,21,180,72,78,128,42,57,37,121,162,126,143,160,19,1,33,124,94,196,36,182,140,178,147,23,189,81,0,85,104,31,74,20,9,144,170,95,38,139,165,46,51,50,34,118,146,123,82,67,32,91,163,25,70,65,16,190,11,113,156,71,8,184,174,191,173,18,131,110,101,59,80,100,30,134,148,195,97,58,175,151,7,102,181,68,4,142,137,158,54,52,119,187,39,107,55,14,13,111,112,89,75,154,15,135,53,183,69,159,164,41,28,155,73,99,106,136,115,152,35,161,172,86,133,76,122,116,44,125,145,56,92,108,192,40,169,129,29,90,60,177,27,43,127,96,171,141,98,114,64,79,179,47,88,5,186,199,83,153,166,24,150,10,185,62,120,197,168,17,48,63];397;False
2066;8112;10178;[21,67,166,174,46,5,27,88,135,150,99,73,140,178,192,10,123,17,8,94,173,18,158,129,24,197,15,9,14,49,182,189,194,65,124,147,130,22,38,105,72,154,75,151,7,153,187,127,39,107,76,122,102,114,101,110,30,134,137,86,181,82,23,12,54,142,121,168,3,98,117,2,81,52,106,118,183,83,26,79,185,148,167,61,59,36,1,93,41,133,96,157,138,45,188,87,66,126,20,146,50,53,51,29,143,156,160,71,69,190,43,128,85,164,111,159,40,37,145,139,33,13,172,195,25,109,141,35,32,56,92,91,78,171,152,57,186,113,196,89,162,198,28,74,4,97,131,0,199,62,44,34,108,6,55,155,184,161,80,58,177,169,191,11,104,180,163,170,95,31,90,125,149,120,68,63,100,116,175,176,193,16,136,144,70,19,64,103,112,84,77,115,179,60,42,47,132,165,119,48];398;False
3841;7026;10867;[194,49,117,22,26,138,176,3,2,130,84,12,77,132,193,109,66,157,103,105,45,188,93,87,6,149,167,61,198,21,180,72,78,128,42,57,37,121,162,126,143,160,19,1,33,124,94,196,36,182,140,178,147,23,189,81,0,85,104,31,74,20,9,144,170,95,38,139,165,46,51,50,34,118,146,123,82,67,32,91,163,25,70,65,16,190,11,113,156,71,8,184,174,191,173,18,131,110,101,59,80,100,30,134,148,195,97,58,175,151,7,102,181,68,4,142,137,158,54,52,119,187,39,107,55,14,13,111,112,89,75,154,15,135,53,183,69,159,164,41,28,155,73,99,106,136,115,152,35,161,172,86,133,76,122,116,44,125,145,56,92,108,192,40,169,129,29,90,60,177,27,43,127,96,171,141,98,114,64,79,179,47,88,5,186,199,83,153,166,24,150,10,185,62,120,197,168,17,48,63];399;False
2065;8093;10158;[21,67,166,174,46,5,27,88,9,150,99,73,140,178,192,10,123,17,8,94,173,18,158,129,24,197,15,135,14,49,182,189,194,65,124,147,130,22,38,105,72,154,75,151,7,153,187,127,39,107,76,122,102,114,101,110,30,134,137,86,181,82,23,12,54,142,121,168,3,98,117,2,81,52,106,118,183,83,26,79,185,148,167,61,59,36,1,93,41,133,96,157,138,45,188,87,66,126,20,146,50,53,51,29,143,156,160,71,69,190,43,128,85,164,111,159,40,37,145,139,33,13,172,195,25,109,141,35,32,56,92,91,78,171,152,57,186,113,196,89,162,198,28,74,4,97,131,0,199,62,44,34,108,6,55,155,184,161,80,58,177,169,191,11,104,180,163,170,95,31,90,125,149,120,68,63,100,116,175,176,193,16,136,144,70,19,64,103,112,84,77,115,179,60,42,47,132,165,119,48];400;False
3815;7024;10839;[136,49,117,22,26,138,176,3,2,130,84,12,77,132,193,109,66,157,103,105,45,188,93,87,6,149,167,61,198,21,180,72,78,128,42,57,37,121,162,126,143,160,19,1,33,124,94,196,36,182,140,178,147,23,189,81,0,85,104,31,74,20,9,144,170,95,38,139,165,46,51,50,34,118,146,123,82,67,32,91,163,25,70,65,16,190,11,113,156,71,8,184,174,191,173,18,131,110,101,59,80,100,30,134,148,195,97,58,175,151,7,102,181,68,4,142,137,158,54,52,119,187,39,107,55,14,13,111,112,89,75,154,15,135,53,183,69,159,164,41,28,155,73,99,106,194,115,152,35,161,172,86,133,76,122,116,44,125,145,56,92,108,192,40,169,129,29,90,60,177,27,43,127,96,171,141,98,114,64,79,179,47,88,5,186,199,83,153,166,24,150,10,185,62,120,197,168,17,48,63];401;False
2081;8087;10168;[143,67,166,174,46,5,27,88,9,150,99,73,140,178,192,10,123,17,8,94,173,18,158,129,24,197,15,135,14,49,182,189,194,65,124,147,130,22,38,105,72,154,75,151,7,153,187,127,39,107,76,122,102,114,101,110,30,134,137,86,181,82,23,12,54,142,121,168,3,98,117,2,81,52,106,118,183,83,26,79,185,148,167,61,59,36,1,93,41,133,96,157,138,45,188,87,66,126,20,146,50,53,51,29,21,156,160,71,69,190,43,128,85,164,111,159,40,37,145,139,33,13,172,195,25,109,141,35,32,56,92,91,78,171,152,57,186,113,196,89,162,198,28,74,4,97,131,0,199,62,44,34,108,6,55,155,184,161,80,58,177,169,191,11,104,180,163,170,95,31,90,125,149,120,68,63,100,116,175,176,193,16,136,144,70,19,64,103,112,84,77,115,179,60,42,47,132,165,119,48];402;False
3789;7030;10819;[19,49,117,22,26,138,176,3,2,130,84,12,77,132,193,109,66,157,103,105,45,188,93,87,6,149,167,61,198,21,180,72,78,128,42,57,37,121,162,126,143,160,136,1,33,124,94,196,36,182,140,178,147,23,189,81,0,85,104,31,74,20,9,144,170,95,38,139,165,46,51,50,34,118,146,123,82,67,32,91,163,25,70,65,16,190,11,113,156,71,8,184,174,191,173,18,131,110,101,59,80,100,30,134,148,195,97,58,175,151,7,102,181,68,4,142,137,158,54,52,119,187,39,107,55,14,13,111,112,89,75,154,15,135,53,183,69,159,164,41,28,155,73,99,106,194,115,152,35,161,172,86,133,76,122,116,44,125,145,56,92,108,192,40,169,129,29,90,60,177,27,43,127,96,171,141,98,114,64,79,179,47,88,5,186,199,83,153,166,24,150,10,185,62,120,197,168,17,48,63];403;False
2071;8090;10161;[147,67,166,174,46,5,27,88,9,150,99,73,140,178,192,10,123,17,8,94,173,18,158,129,24,197,15,135,14,49,182,189,194,65,124,143,130,22,38,105,72,154,75,151,7,153,187,127,39,107,76,122,102,114,101,110,30,134,137,86,181,82,23,12,54,142,121,168,3,98,117,2,81,52,106,118,183,83,26,79,185,148,167,61,59,36,1,93,41,133,96,157,138,45,188,87,66,126,20,146,50,53,51,29,21,156,160,71,69,190,43,128,85,164,111,159,40,37,145,139,33,13,172,195,25,109,141,35,32,56,92,91,78,171,152,57,186,113,196,89,162,198,28,74,4,97,131,0,199,62,44,34,108,6,55,155,184,161,80,58,177,169,191,11,104,180,163,170,95,31,90,125,149,120,68,63,100,116,175,176,193,16,136,144,70,19,64,103,112,84,77,115,179,60,42,47,132,165,119,48];404;False
3720;7044;10764;[198,49,117,22,26,138,176,3,2,130,84,12,77,132,193,109,66,157,103,105,45,188,93,87,6,149,167,61,19,21,180,72,78,128,42,57,37,121,162,126,143,160,136,1,33,124,94,196,36,182,140,178,147,23,189,81,0,85,104,31,74,20,9,144,170,95,38,139,165,46,51,50,34,118,146,123,82,67,32,91,163,25,70,65,16,190,11,113,156,71,8,184,174,191,173,18,131,110,101,59,80,100,30,134,148,195,97,58,175,151,7,102,181,68,4,142,137,158,54,52,119,187,39,107,55,14,13,111,112,89,75,154,15,135,53,183,69,159,164,41,28,155,73,99,106,194,115,152,35,161,172,86,133,76,122,116,44,125,145,56,92,108,192,40,169,129,29,90,60,177,27,43,127,96,171,141,98,114,64,79,179,47,88,5,186,199,83,153,166,24,150,10,185,62,120,197,168,17,48,63];405;False
2081;8072;10153;[147,67,166,174,1,5,27,88,9,150,99,73,140,178,192,10,123,17,8,94,173,18,158,129,24,197,15,135,14,49,182,189,194,65,124,143,130,22,38,105,72,154,75,151,7,153,187,127,39,107,76,122,102,114,101,110,30,134,137,86,181,82,23,12,54,142,121,168,3,98,117,2,81,52,106,118,183,83,26,79,185,148,167,61,59,36,46,93,41,133,96,157,138,45,188,87,66,126,20,146,50,53,51,29,21,156,160,71,69,190,43,128,85,164,111,159,40,37,145,139,33,13,172,195,25,109,141,35,32,56,92,91,78,171,152,57,186,113,196,89,162,198,28,74,4,97,131,0,199,62,44,34,108,6,55,155,184,161,80,58,177,169,191,11,104,180,163,170,95,31,90,125,149,120,68,63,100,116,175,176,193,16,136,144,70,19,64,103,112,84,77,115,179,60,42,47,132,165,119,48];406;False
3676;7049;10725;[4,49,117,22,26,138,176,3,2,130,84,12,77,132,193,109,66,157,103,105,45,188,93,87,6,149,167,61,19,21,180,72,78,128,42,57,37,121,162,126,143,160,136,1,33,124,94,196,36,182,140,178,147,23,189,81,0,85,104,31,74,20,9,144,170,95,38,139,165,46,51,50,34,118,146,123,82,67,32,91,163,25,70,65,16,190,11,113,156,71,8,184,174,191,173,18,131,110,101,59,80,100,30,134,148,195,97,58,175,151,7,102,181,68,198,142,137,158,54,52,119,187,39,107,55,14,13,111,112,89,75,154,15,135,53,183,69,159,164,41,28,155,73,99,106,194,115,152,35,161,172,86,133,76,122,116,44,125,145,56,92,108,192,40,169,129,29,90,60,177,27,43,127,96,171,141,98,114,64,79,179,47,88,5,186,199,83,153,166,24,150,10,185,62,120,197,168,17,48,63];407;False
2091;8069;10160;[143,67,166,174,1,5,27,88,9,150,99,73,140,178,192,10,123,17,8,94,173,18,158,129,24,197,15,135,14,49,182,189,194,65,124,147,130,22,38,105,72,154,75,151,7,153,187,127,39,107,76,122,102,114,101,110,30,134,137,86,181,82,23,12,54,142,121,168,3,98,117,2,81,52,106,118,183,83,26,79,185,148,167,61,59,36,46,93,41,133,96,157,138,45,188,87,66,126,20,146,50,53,51,29,21,156,160,71,69,190,43,128,85,164,111,159,40,37,145,139,33,13,172,195,25,109,141,35,32,56,92,91,78,171,152,57,186,113,196,89,162,198,28,74,4,97,131,0,199,62,44,34,108,6,55,155,184,161,80,58,177,169,191,11,104,180,163,170,95,31,90,125,149,120,68,63,100,116,175,176,193,16,136,144,70,19,64,103,112,84,77,115,179,60,42,47,132,165,119,48];408;False
3751;7031;10782;[19,49,117,22,26,138,176,3,2,130,84,12,77,132,193,109,66,157,103,105,45,188,93,87,6,149,167,61,4,21,180,72,78,128,42,57,37,121,162,126,143,160,136,1,33,124,94,196,36,182,140,178,147,23,189,81,0,85,104,31,74,20,9,144,170,95,38,139,165,46,51,50,34,118,146,123,82,67,32,91,163,25,70,65,16,190,11,113,156,71,8,184,174,191,173,18,131,110,101,59,80,100,30,134,148,195,97,58,175,151,7,102,181,68,198,142,137,158,54,52,119,187,39,107,55,14,13,111,112,89,75,154,15,135,53,183,69,159,164,41,28,155,73,99,106,194,115,152,35,161,172,86,133,76,122,116,44,125,145,56,92,108,192,40,169,129,29,90,60,177,27,43,127,96,171,141,98,114,64,79,179,47,88,5,186,199,83,153,166,24,150,10,185,62,120,197,168,17,48,63];409;False
2075;8075;10150;[21,67,166,174,1,5,27,88,9,150,99,73,140,178,192,10,123,17,8,94,173,18,158,129,24,197,15,135,14,49,182,189,194,65,124,147,130,22,38,105,72,154,75,151,7,153,187,127,39,107,76,122,102,114,101,110,30,134,137,86,181,82,23,12,54,142,121,168,3,98,117,2,81,52,106,118,183,83,26,79,185,148,167,61,59,36,46,93,41,133,96,157,138,45,188,87,66,126,20,146,50,53,51,29,143,156,160,71,69,190,43,128,85,164,111,159,40,37,145,139,33,13,172,195,25,109,141,35,32,56,92,91,78,171,152,57,186,113,196,89,162,198,28,74,4,97,131,0,199,62,44,34,108,6,55,155,184,161,80,58,177,169,191,11,104,180,163,170,95,31,90,125,149,120,68,63,100,116,175,176,193,16,136,144,70,19,64,103,112,84,77,115,179,60,42,47,132,165,119,48];410;False
3777;7025;10802;[136,49,117,22,26,138,176,3,2,130,84,12,77,132,193,109,66,157,103,105,45,188,93,87,6,149,167,61,4,21,180,72,78,128,42,57,37,121,162,126,143,160,19,1,33,124,94,196,36,182,140,178,147,23,189,81,0,85,104,31,74,20,9,144,170,95,38,139,165,46,51,50,34,118,146,123,82,67,32,91,163,25,70,65,16,190,11,113,156,71,8,184,174,191,173,18,131,110,101,59,80,100,30,134,148,195,97,58,175,151,7,102,181,68,198,142,137,158,54,52,119,187,39,107,55,14,13,111,112,89,75,154,15,135,53,183,69,159,164,41,28,155,73,99,106,194,115,152,35,161,172,86,133,76,122,116,44,125,145,56,92,108,192,40,169,129,29,90,60,177,27,43,127,96,171,141,98,114,64,79,179,47,88,5,186,199,83,153,166,24,150,10,185,62,120,197,168,17,48,63];411;False
2060;8106;10166;[55,67,166,174,1,5,27,88,9,150,99,73,140,178,192,10,123,17,8,94,173,18,158,129,24,197,15,135,14,49,182,189,194,65,124,147,130,22,38,105,72,154,75,151,7,153,187,127,39,107,76,122,102,114,101,110,30,134,137,86,181,82,23,12,54,142,121,168,3,98,117,2,81,52,106,118,183,83,26,79,185,148,167,61,59,36,46,93,41,133,96,157,138,45,188,87,66,126,20,146,50,53,51,29,143,156,160,71,69,190,43,128,85,164,111,159,40,37,145,139,33,13,172,195,25,109,141,35,32,56,92,91,78,171,152,57,186,113,196,89,162,198,28,74,4,97,131,0,199,62,44,34,108,6,21,155,184,161,80,58,177,169,191,11,104,180,163,170,95,31,90,125,149,120,68,63,100,116,175,176,193,16,136,144,70,19,64,103,112,84,77,115,179,60,42,47,132,165,119,48];412;False
3745;7039;10784;[146,49,117,22,26,138,176,3,2,130,84,12,77,132,193,109,66,157,103,105,45,188,93,87,6,149,167,61,4,21,180,72,78,128,42,57,37,121,162,126,143,160,19,1,33,124,94,196,36,182,140,178,147,23,189,81,0,85,104,31,74,20,9,144,170,95,38,139,165,46,51,50,34,118,136,123,82,67,32,91,163,25,70,65,16,190,11,113,156,71,8,184,174,191,173,18,131,110,101,59,80,100,30,134,148,195,97,58,175,151,7,102,181,68,198,142,137,158,54,52,119,187,39,107,55,14,13,111,112,89,75,154,15,135,53,183,69,159,164,41,28,155,73,99,106,194,115,152,35,161,172,86,133,76,122,116,44,125,145,56,92,108,192,40,169,129,29,90,60,177,27,43,127,96,171,141,98,114,64,79,179,47,88,5,186,199,83,153,166,24,150,10,185,62,120,197,168,17,48,63];413;False
2050;8111;10161;[67,55,166,174,1,5,27,88,9,150,99,73,140,178,192,10,123,17,8,94,173,18,158,129,24,197,15,135,14,49,182,189,194,65,124,147,130,22,38,105,72,154,75,151,7,153,187,127,39,107,76,122,102,114,101,110,30,134,137,86,181,82,23,12,54,142,121,168,3,98,117,2,81,52,106,118,183,83,26,79,185,148,167,61,59,36,46,93,41,133,96,157,138,45,188,87,66,126,20,146,50,53,51,29,143,156,160,71,69,190,43,128,85,164,111,159,40,37,145,139,33,13,172,195,25,109,141,35,32,56,92,91,78,171,152,57,186,113,196,89,162,198,28,74,4,97,131,0,199,62,44,34,108,6,21,155,184,161,80,58,177,169,191,11,104,180,163,170,95,31,90,125,149,120,68,63,100,116,175,176,193,16,136,144,70,19,64,103,112,84,77,115,179,60,42,47,132,165,119,48];414;False
2068;8060;10128;[174,67,166,55,1,5,27,88,9,150,99,73,140,178,192,10,123,17,8,94,173,18,158,129,24,197,15,135,14,49,182,189,194,65,124,147,130,22,38,105,72,154,75,151,7,153,187,127,39,107,76,122,102,114,101,110,30,134,137,86,181,82,23,12,54,142,121,168,3,98,117,2,81,52,106,118,183,83,26,79,185,148,167,61,59,36,46,93,41,133,96,157,138,45,188,87,66,126,20,146,50,53,51,29,143,156,160,71,69,190,43,128,85,164,111,159,40,37,145,139,33,13,172,195,25,109,141,35,32,56,92,91,78,171,152,57,186,113,196,89,162,198,28,74,4,97,131,0,199,62,44,34,108,6,21,155,184,161,80,58,177,169,191,11,104,180,163,170,95,31,90,125,149,120,68,63,100,116,175,176,193,16,136,144,70,19,64,103,112,84,77,115,179,60,42,47,132,165,119,48];415;False
3702;7042;10744;[4,49,117,22,26,138,176,3,2,130,84,12,77,132,193,109,66,157,103,105,45,188,93,87,6,149,167,61,146,21,180,72,78,128,42,57,37,121,162,126,143,160,19,1,33,124,94,196,36,182,140,178,147,23,189,81,0,85,104,31,74,20,9,144,170,95,38,139,165,46,51,50,34,118,136,123,82,67,32,91,163,25,70,65,16,190,11,113,156,71,8,184,174,191,173,18,131,110,101,59,80,100,30,134,148,195,97,58,175,151,7,102,181,68,198,142,137,158,54,52,119,187,39,107,55,14,13,111,112,89,75,154,15,135,53,183,69,159,164,41,28,155,73,99,106,194,115,152,35,161,172,86,133,76,122,116,44,125,145,56,92,108,192,40,169,129,29,90,60,177,27,43,127,96,171,141,98,114,64,79,179,47,88,5,186,199,83,153,166,24,150,10,185,62,120,197,168,17,48,63];416;False
2058;8108;10166;[182,55,166,174,1,5,27,88,9,150,99,73,140,178,192,10,123,17,8,94,173,18,158,129,24,197,15,135,14,49,67,189,194,65,124,147,130,22,38,105,72,154,75,151,7,153,187,127,39,107,76,122,102,114,101,110,30,134,137,86,181,82,23,12,54,142,121,168,3,98,117,2,81,52,106,118,183,83,26,79,185,148,167,61,59,36,46,93,41,133,96,157,138,45,188,87,66,126,20,146,50,53,51,29,143,156,160,71,69,190,43,128,85,164,111,159,40,37,145,139,33,13,172,195,25,109,141,35,32,56,92,91,78,171,152,57,186,113,196,89,162,198,28,74,4,97,131,0,199,62,44,34,108,6,21,155,184,161,80,58,177,169,191,11,104,180,163,170,95,31,90,125,149,120,68,63,100,116,175,176,193,16,136,144,70,19,64,103,112,84,77,115,179,60,42,47,132,165,119,48];417;False
2059;8102;10161;[49,67,166,55,1,5,27,88,9,150,99,73,140,178,192,10,123,17,8,94,173,18,158,129,24,197,15,135,14,174,182,189,194,65,124,147,130,22,38,105,72,154,75,151,7,153,187,127,39,107,76,122,102,114,101,110,30,134,137,86,181,82,23,12,54,142,121,168,3,98,117,2,81,52,106,118,183,83,26,79,185,148,167,61,59,36,46,93,41,133,96,157,138,45,188,87,66,126,20,146,50,53,51,29,143,156,160,71,69,190,43,128,85,164,111,159,40,37,145,139,33,13,172,195,25,109,141,35,32,56,92,91,78,171,152,57,186,113,196,89,162,198,28,74,4,97,131,0,199,62,44,34,108,6,21,155,184,161,80,58,177,169,191,11,104,180,163,170,95,31,90,125,149,120,68,63,100,116,175,176,193,16,136,144,70,19,64,103,112,84,77,115,179,60,42,47,132,165,119,48];418;False
3673;7048;10721;[34,49,117,22,26,138,176,3,2,130,84,12,77,132,193,109,66,157,103,105,45,188,93,87,6,149,167,61,146,21,180,72,78,128,42,57,37,121,162,126,143,160,19,1,33,124,94,196,36,182,140,178,147,23,189,81,0,85,104,31,74,20,9,144,170,95,38,139,165,46,51,50,4,118,136,123,82,67,32,91,163,25,70,65,16,190,11,113,156,71,8,184,174,191,173,18,131,110,101,59,80,100,30,134,148,195,97,58,175,151,7,102,181,68,198,142,137,158,54,52,119,187,39,107,55,14,13,111,112,89,75,154,15,135,53,183,69,159,164,41,28,155,73,99,106,194,115,152,35,161,172,86,133,76,122,116,44,125,145,56,92,108,192,40,169,129,29,90,60,177,27,43,127,96,171,141,98,114,64,79,179,47,88,5,186,199,83,153,166,24,150,10,185,62,120,197,168,17,48,63];419;False
2021;8079;10100;[194,55,166,174,1,5,27,88,9,150,99,73,140,178,192,10,123,17,8,94,173,18,158,129,24,197,15,135,14,49,67,189,182,65,124,147,130,22,38,105,72,154,75,151,7,153,187,127,39,107,76,122,102,114,101,110,30,134,137,86,181,82,23,12,54,142,121,168,3,98,117,2,81,52,106,118,183,83,26,79,185,148,167,61,59,36,46,93,41,133,96,157,138,45,188,87,66,126,20,146,50,53,51,29,143,156,160,71,69,190,43,128,85,164,111,159,40,37,145,139,33,13,172,195,25,109,141,35,32,56,92,91,78,171,152,57,186,113,196,89,162,198,28,74,4,97,131,0,199,62,44,34,108,6,21,155,184,161,80,58,177,169,191,11,104,180,163,170,95,31,90,125,149,120,68,63,100,116,175,176,193,16,136,144,70,19,64,103,112,84,77,115,179,60,42,47,132,165,119,48];420;False
3652;7028;10680;[34,187,117,22,26,138,176,3,2,130,84,12,77,132,193,109,66,157,103,105,45,188,93,87,6,149,167,61,146,21,180,72,78,128,42,57,37,121,162,126,143,160,19,1,33,124,94,196,36,182,140,178,147,23,189,81,0,85,104,31,74,20,9,144,170,95,38,139,165,46,51,50,4,118,136,123,82,67,32,91,163,25,70,65,16,190,11,113,156,71,8,184,174,191,173,18,131,110,101,59,80,100,30,134,148,195,97,58,175,151,7,102,181,68,198,142,137,158,54,52,119,49,39,107,55,14,13,111,112,89,75,154,15,135,53,183,69,159,164,41,28,155,73,99,106,194,115,152,35,161,172,86,133,76,122,116,44,125,145,56,92,108,192,40,169,129,29,90,60,177,27,43,127,96,171,141,98,114,64,79,179,47,88,5,186,199,83,153,166,24,150,10,185,62,120,197,168,17,48,63];421;False
2014;8099;10113;[192,55,166,174,1,5,27,88,9,150,99,73,140,178,194,10,123,17,8,94,173,18,158,129,24,197,15,135,14,49,67,189,182,65,124,147,130,22,38,105,72,154,75,151,7,153,187,127,39,107,76,122,102,114,101,110,30,134,137,86,181,82,23,12,54,142,121,168,3,98,117,2,81,52,106,118,183,83,26,79,185,148,167,61,59,36,46,93,41,133,96,157,138,45,188,87,66,126,20,146,50,53,51,29,143,156,160,71,69,190,43,128,85,164,111,159,40,37,145,139,33,13,172,195,25,109,141,35,32,56,92,91,78,171,152,57,186,113,196,89,162,198,28,74,4,97,131,0,199,62,44,34,108,6,21,155,184,161,80,58,177,169,191,11,104,180,163,170,95,31,90,125,149,120,68,63,100,116,175,176,193,16,136,144,70,19,64,103,112,84,77,115,179,60,42,47,132,165,119,48];422;False
3719;7022;10741;[4,187,117,22,26,138,176,3,2,130,84,12,77,132,193,109,66,157,103,105,45,188,93,87,6,149,167,61,146,21,180,72,78,128,42,57,37,121,162,126,143,160,19,1,33,124,94,196,36,182,140,178,147,23,189,81,0,85,104,31,74,20,9,144,170,95,38,139,165,46,51,50,34,118,136,123,82,67,32,91,163,25,70,65,16,190,11,113,156,71,8,184,174,191,173,18,131,110,101,59,80,100,30,134,148,195,97,58,175,151,7,102,181,68,198,142,137,158,54,52,119,49,39,107,55,14,13,111,112,89,75,154,15,135,53,183,69,159,164,41,28,155,73,99,106,194,115,152,35,161,172,86,133,76,122,116,44,125,145,56,92,108,192,40,169,129,29,90,60,177,27,43,127,96,171,141,98,114,64,79,179,47,88,5,186,199,83,153,166,24,150,10,185,62,120,197,168,17,48,63];423;False
2004;8117;10121;[192,55,166,174,46,5,27,88,9,150,99,73,140,178,194,10,123,17,8,94,173,18,158,129,24,197,15,135,14,49,67,189,182,65,124,147,130,22,38,105,72,154,75,151,7,153,187,127,39,107,76,122,102,114,101,110,30,134,137,86,181,82,23,12,54,142,121,168,3,98,117,2,81,52,106,118,183,83,26,79,185,148,167,61,59,36,1,93,41,133,96,157,138,45,188,87,66,126,20,146,50,53,51,29,143,156,160,71,69,190,43,128,85,164,111,159,40,37,145,139,33,13,172,195,25,109,141,35,32,56,92,91,78,171,152,57,186,113,196,89,162,198,28,74,4,97,131,0,199,62,44,34,108,6,21,155,184,161,80,58,177,169,191,11,104,180,163,170,95,31,90,125,149,120,68,63,100,116,175,176,193,16,136,144,70,19,64,103,112,84,77,115,179,60,42,47,132,165,119,48];424;False
3772;7017;10789;[198,187,117,22,26,138,176,3,2,130,84,12,77,132,193,109,66,157,103,105,45,188,93,87,6,149,167,61,146,21,180,72,78,128,42,57,37,121,162,126,143,160,19,1,33,124,94,196,36,182,140,178,147,23,189,81,0,85,104,31,74,20,9,144,170,95,38,139,165,46,51,50,34,118,136,123,82,67,32,91,163,25,70,65,16,190,11,113,156,71,8,184,174,191,173,18,131,110,101,59,80,100,30,134,148,195,97,58,175,151,7,102,181,68,4,142,137,158,54,52,119,49,39,107,55,14,13,111,112,89,75,154,15,135,53,183,69,159,164,41,28,155,73,99,106,194,115,152,35,161,172,86,133,76,122,116,44,125,145,56,92,108,192,40,169,129,29,90,60,177,27,43,127,96,171,141,98,114,64,79,179,47,88,5,186,199,83,153,166,24,150,10,185,62,120,197,168,17,48,63];425;False
2011;8097;10108;[194,55,166,174,46,5,27,88,9,150,99,73,140,178,192,10,123,17,8,94,173,18,158,129,24,197,15,135,14,49,67,189,182,65,124,147,130,22,38,105,72,154,75,151,7,153,187,127,39,107,76,122,102,114,101,110,30,134,137,86,181,82,23,12,54,142,121,168,3,98,117,2,81,52,106,118,183,83,26,79,185,148,167,61,59,36,1,93,41,133,96,157,138,45,188,87,66,126,20,146,50,53,51,29,143,156,160,71,69,190,43,128,85,164,111,159,40,37,145,139,33,13,172,195,25,109,141,35,32,56,92,91,78,171,152,57,186,113,196,89,162,198,28,74,4,97,131,0,199,62,44,34,108,6,21,155,184,161,80,58,177,169,191,11,104,180,163,170,95,31,90,125,149,120,68,63,100,116,175,176,193,16,136,144,70,19,64,103,112,84,77,115,179,60,42,47,132,165,119,48];426;False
3844;7012;10856;[198,84,117,22,26,138,176,3,2,130,187,12,77,132,193,109,66,157,103,105,45,188,93,87,6,149,167,61,146,21,180,72,78,128,42,57,37,121,162,126,143,160,19,1,33,124,94,196,36,182,140,178,147,23,189,81,0,85,104,31,74,20,9,144,170,95,38,139,165,46,51,50,34,118,136,123,82,67,32,91,163,25,70,65,16,190,11,113,156,71,8,184,174,191,173,18,131,110,101,59,80,100,30,134,148,195,97,58,175,151,7,102,181,68,4,142,137,158,54,52,119,49,39,107,55,14,13,111,112,89,75,154,15,135,53,183,69,159,164,41,28,155,73,99,106,194,115,152,35,161,172,86,133,76,122,116,44,125,145,56,92,108,192,40,169,129,29,90,60,177,27,43,127,96,171,141,98,114,64,79,179,47,88,5,186,199,83,153,166,24,150,10,185,62,120,197,168,17,48,63];427;False
1997;8131;10128;[147,55,166,174,46,5,27,88,9,150,99,73,140,178,192,10,123,17,8,94,173,18,158,129,24,197,15,135,14,49,67,189,182,65,124,194,130,22,38,105,72,154,75,151,7,153,187,127,39,107,76,122,102,114,101,110,30,134,137,86,181,82,23,12,54,142,121,168,3,98,117,2,81,52,106,118,183,83,26,79,185,148,167,61,59,36,1,93,41,133,96,157,138,45,188,87,66,126,20,146,50,53,51,29,143,156,160,71,69,190,43,128,85,164,111,159,40,37,145,139,33,13,172,195,25,109,141,35,32,56,92,91,78,171,152,57,186,113,196,89,162,198,28,74,4,97,131,0,199,62,44,34,108,6,21,155,184,161,80,58,177,169,191,11,104,180,163,170,95,31,90,125,149,120,68,63,100,116,175,176,193,16,136,144,70,19,64,103,112,84,77,115,179,60,42,47,132,165,119,48];428;False
3806;7016;10822;[198,19,117,22,26,138,176,3,2,130,187,12,77,132,193,109,66,157,103,105,45,188,93,87,6,149,167,61,146,21,180,72,78,128,42,57,37,121,162,126,143,160,84,1,33,124,94,196,36,182,140,178,147,23,189,81,0,85,104,31,74,20,9,144,170,95,38,139,165,46,51,50,34,118,136,123,82,67,32,91,163,25,70,65,16,190,11,113,156,71,8,184,174,191,173,18,131,110,101,59,80,100,30,134,148,195,97,58,175,151,7,102,181,68,4,142,137,158,54,52,119,49,39,107,55,14,13,111,112,89,75,154,15,135,53,183,69,159,164,41,28,155,73,99,106,194,115,152,35,161,172,86,133,76,122,116,44,125,145,56,92,108,192,40,169,129,29,90,60,177,27,43,127,96,171,141,98,114,64,79,179,47,88,5,186,199,83,153,166,24,150,10,185,62,120,197,168,17,48,63];429;False
1963;8152;10115;[88,55,166,174,46,5,27,147,9,150,99,73,140,178,192,10,123,17,8,94,173,18,158,129,24,197,15,135,14,49,67,189,182,65,124,194,130,22,38,105,72,154,75,151,7,153,187,127,39,107,76,122,102,114,101,110,30,134,137,86,181,82,23,12,54,142,121,168,3,98,117,2,81,52,106,118,183,83,26,79,185,148,167,61,59,36,1,93,41,133,96,157,138,45,188,87,66,126,20,146,50,53,51,29,143,156,160,71,69,190,43,128,85,164,111,159,40,37,145,139,33,13,172,195,25,109,141,35,32,56,92,91,78,171,152,57,186,113,196,89,162,198,28,74,4,97,131,0,199,62,44,34,108,6,21,155,184,161,80,58,177,169,191,11,104,180,163,170,95,31,90,125,149,120,68,63,100,116,175,176,193,16,136,144,70,19,64,103,112,84,77,115,179,60,42,47,132,165,119,48];430;False
3843;7011;10854;[198,9,117,22,26,138,176,3,2,130,187,12,77,132,193,109,66,157,103,105,45,188,93,87,6,149,167,61,146,21,180,72,78,128,42,57,37,121,162,126,143,160,84,1,33,124,94,196,36,182,140,178,147,23,189,81,0,85,104,31,74,20,19,144,170,95,38,139,165,46,51,50,34,118,136,123,82,67,32,91,163,25,70,65,16,190,11,113,156,71,8,184,174,191,173,18,131,110,101,59,80,100,30,134,148,195,97,58,175,151,7,102,181,68,4,142,137,158,54,52,119,49,39,107,55,14,13,111,112,89,75,154,15,135,53,183,69,159,164,41,28,155,73,99,106,194,115,152,35,161,172,86,133,76,122,116,44,125,145,56,92,108,192,40,169,129,29,90,60,177,27,43,127,96,171,141,98,114,64,79,179,47,88,5,186,199,83,153,166,24,150,10,185,62,120,197,168,17,48,63];431;False
1983;8150;10133;[46,55,166,174,88,5,27,147,9,150,99,73,140,178,192,10,123,17,8,94,173,18,158,129,24,197,15,135,14,49,67,189,182,65,124,194,130,22,38,105,72,154,75,151,7,153,187,127,39,107,76,122,102,114,101,110,30,134,137,86,181,82,23,12,54,142,121,168,3,98,117,2,81,52,106,118,183,83,26,79,185,148,167,61,59,36,1,93,41,133,96,157,138,45,188,87,66,126,20,146,50,53,51,29,143,156,160,71,69,190,43,128,85,164,111,159,40,37,145,139,33,13,172,195,25,109,141,35,32,56,92,91,78,171,152,57,186,113,196,89,162,198,28,74,4,97,131,0,199,62,44,34,108,6,21,155,184,161,80,58,177,169,191,11,104,180,163,170,95,31,90,125,149,120,68,63,100,116,175,176,193,16,136,144,70,19,64,103,112,84,77,115,179,60,42,47,132,165,119,48];432;False
3802;7016;10818;[4,9,117,22,26,138,176,3,2,130,187,12,77,132,193,109,66,157,103,105,45,188,93,87,6,149,167,61,146,21,180,72,78,128,42,57,37,121,162,126,143,160,84,1,33,124,94,196,36,182,140,178,147,23,189,81,0,85,104,31,74,20,19,144,170,95,38,139,165,46,51,50,34,118,136,123,82,67,32,91,163,25,70,65,16,190,11,113,156,71,8,184,174,191,173,18,131,110,101,59,80,100,30,134,148,195,97,58,175,151,7,102,181,68,198,142,137,158,54,52,119,49,39,107,55,14,13,111,112,89,75,154,15,135,53,183,69,159,164,41,28,155,73,99,106,194,115,152,35,161,172,86,133,76,122,116,44,125,145,56,92,108,192,40,169,129,29,90,60,177,27,43,127,96,171,141,98,114,64,79,179,47,88,5,186,199,83,153,166,24,150,10,185,62,120,197,168,17,48,63];433;False
2000;8118;10118;[194,55,166,174,88,5,27,147,9,150,99,73,140,178,192,10,123,17,8,94,173,18,158,129,24,197,15,135,14,49,67,189,182,65,124,46,130,22,38,105,72,154,75,151,7,153,187,127,39,107,76,122,102,114,101,110,30,134,137,86,181,82,23,12,54,142,121,168,3,98,117,2,81,52,106,118,183,83,26,79,185,148,167,61,59,36,1,93,41,133,96,157,138,45,188,87,66,126,20,146,50,53,51,29,143,156,160,71,69,190,43,128,85,164,111,159,40,37,145,139,33,13,172,195,25,109,141,35,32,56,92,91,78,171,152,57,186,113,196,89,162,198,28,74,4,97,131,0,199,62,44,34,108,6,21,155,184,161,80,58,177,169,191,11,104,180,163,170,95,31,90,125,149,120,68,63,100,116,175,176,193,16,136,144,70,19,64,103,112,84,77,115,179,60,42,47,132,165,119,48];434;False
3856;7009;10865;[194,9,117,22,26,138,176,3,2,130,187,12,77,132,193,109,66,157,103,105,45,188,93,87,6,149,167,61,146,21,180,72,78,128,42,57,37,121,162,126,143,160,84,1,33,124,94,196,36,182,140,178,147,23,189,81,0,85,104,31,74,20,19,144,170,95,38,139,165,46,51,50,34,118,136,123,82,67,32,91,163,25,70,65,16,190,11,113,156,71,8,184,174,191,173,18,131,110,101,59,80,100,30,134,148,195,97,58,175,151,7,102,181,68,198,142,137,158,54,52,119,49,39,107,55,14,13,111,112,89,75,154,15,135,53,183,69,159,164,41,28,155,73,99,106,4,115,152,35,161,172,86,133,76,122,116,44,125,145,56,92,108,192,40,169,129,29,90,60,177,27,43,127,96,171,141,98,114,64,79,179,47,88,5,186,199,83,153,166,24,150,10,185,62,120,197,168,17,48,63];435;False
1993;8138;10131;[192,55,166,174,88,5,27,147,9,150,99,73,140,178,194,10,123,17,8,94,173,18,158,129,24,197,15,135,14,49,67,189,182,65,124,46,130,22,38,105,72,154,75,151,7,153,187,127,39,107,76,122,102,114,101,110,30,134,137,86,181,82,23,12,54,142,121,168,3,98,117,2,81,52,106,118,183,83,26,79,185,148,167,61,59,36,1,93,41,133,96,157,138,45,188,87,66,126,20,146,50,53,51,29,143,156,160,71,69,190,43,128,85,164,111,159,40,37,145,139,33,13,172,195,25,109,141,35,32,56,92,91,78,171,152,57,186,113,196,89,162,198,28,74,4,97,131,0,199,62,44,34,108,6,21,155,184,161,80,58,177,169,191,11,104,180,163,170,95,31,90,125,149,120,68,63,100,116,175,176,193,16,136,144,70,19,64,103,112,84,77,115,179,60,42,47,132,165,119,48];436;False
3955;7008;10963;[146,9,117,22,26,138,176,3,2,130,187,12,77,132,193,109,66,157,103,105,45,188,93,87,6,149,167,61,194,21,180,72,78,128,42,57,37,121,162,126,143,160,84,1,33,124,94,196,36,182,140,178,147,23,189,81,0,85,104,31,74,20,19,144,170,95,38,139,165,46,51,50,34,118,136,123,82,67,32,91,163,25,70,65,16,190,11,113,156,71,8,184,174,191,173,18,131,110,101,59,80,100,30,134,148,195,97,58,175,151,7,102,181,68,198,142,137,158,54,52,119,49,39,107,55,14,13,111,112,89,75,154,15,135,53,183,69,159,164,41,28,155,73,99,106,4,115,152,35,161,172,86,133,76,122,116,44,125,145,56,92,108,192,40,169,129,29,90,60,177,27,43,127,96,171,141,98,114,64,79,179,47,88,5,186,199,83,153,166,24,150,10,185,62,120,197,168,17,48,63];437;False
1990;8149;10139;[192,55,166,174,88,5,27,147,9,150,99,73,140,178,194,10,123,17,8,94,173,18,158,129,24,197,15,135,14,49,195,189,182,65,124,46,130,22,38,105,72,154,75,151,7,153,187,127,39,107,76,122,102,114,101,110,30,134,137,86,181,82,23,12,54,142,121,168,3,98,117,2,81,52,106,118,183,83,26,79,185,148,167,61,59,36,1,93,41,133,96,157,138,45,188,87,66,126,20,146,50,53,51,29,143,156,160,71,69,190,43,128,85,164,111,159,40,37,145,139,33,13,172,67,25,109,141,35,32,56,92,91,78,171,152,57,186,113,196,89,162,198,28,74,4,97,131,0,199,62,44,34,108,6,21,155,184,161,80,58,177,169,191,11,104,180,163,170,95,31,90,125,149,120,68,63,100,116,175,176,193,16,136,144,70,19,64,103,112,84,77,115,179,60,42,47,132,165,119,48];438;False
3988;6996;10984;[180,9,117,22,26,138,176,3,2,130,187,12,77,132,193,109,66,157,103,105,45,188,93,87,6,149,167,61,194,21,146,72,78,128,42,57,37,121,162,126,143,160,84,1,33,124,94,196,36,182,140,178,147,23,189,81,0,85,104,31,74,20,19,144,170,95,38,139,165,46,51,50,34,118,136,123,82,67,32,91,163,25,70,65,16,190,11,113,156,71,8,184,174,191,173,18,131,110,101,59,80,100,30,134,148,195,97,58,175,151,7,102,181,68,198,142,137,158,54,52,119,49,39,107,55,14,13,111,112,89,75,154,15,135,53,183,69,159,164,41,28,155,73,99,106,4,115,152,35,161,172,86,133,76,122,116,44,125,145,56,92,108,192,40,169,129,29,90,60,177,27,43,127,96,171,141,98,114,64,79,179,47,88,5,186,199,83,153,166,24,150,10,185,62,120,197,168,17,48,63];439;False
1997;8129;10126;[194,55,166,174,88,5,27,147,9,150,99,73,140,178,192,10,123,17,8,94,173,18,158,129,24,197,15,135,14,49,195,189,182,65,124,46,130,22,38,105,72,154,75,151,7,153,187,127,39,107,76,122,102,114,101,110,30,134,137,86,181,82,23,12,54,142,121,168,3,98,117,2,81,52,106,118,183,83,26,79,185,148,167,61,59,36,1,93,41,133,96,157,138,45,188,87,66,126,20,146,50,53,51,29,143,156,160,71,69,190,43,128,85,164,111,159,40,37,145,139,33,13,172,67,25,109,141,35,32,56,92,91,78,171,152,57,186,113,196,89,162,198,28,74,4,97,131,0,199,62,44,34,108,6,21,155,184,161,80,58,177,169,191,11,104,180,163,170,95,31,90,125,149,120,68,63,100,116,175,176,193,16,136,144,70,19,64,103,112,84,77,115,179,60,42,47,132,165,119,48];440;False
3955;6998;10953;[34,9,117,22,26,138,176,3,2,130,187,12,77,132,193,109,66,157,103,105,45,188,93,87,6,149,167,61,194,21,146,72,78,128,42,57,37,121,162,126,143,160,84,1,33,124,94,196,36,182,140,178,147,23,189,81,0,85,104,31,74,20,19,144,170,95,38,139,165,46,51,50,180,118,136,123,82,67,32,91,163,25,70,65,16,190,11,113,156,71,8,184,174,191,173,18,131,110,101,59,80,100,30,134,148,195,97,58,175,151,7,102,181,68,198,142,137,158,54,52,119,49,39,107,55,14,13,111,112,89,75,154,15,135,53,183,69,159,164,41,28,155,73,99,106,4,115,152,35,161,172,86,133,76,122,116,44,125,145,56,92,108,192,40,169,129,29,90,60,177,27,43,127,96,171,141,98,114,64,79,179,47,88,5,186,199,83,153,166,24,150,10,185,62,120,197,168,17,48,63];441;False
1991;8143;10134;[194,55,166,91,88,5,27,147,9,150,99,73,140,178,192,10,123,17,8,94,173,18,158,129,24,197,15,135,14,49,195,189,182,65,124,46,130,22,38,105,72,154,75,151,7,153,187,127,39,107,76,122,102,114,101,110,30,134,137,86,181,82,23,12,54,142,121,168,3,98,117,2,81,52,106,118,183,83,26,79,185,148,167,61,59,36,1,93,41,133,96,157,138,45,188,87,66,126,20,146,50,53,51,29,143,156,160,71,69,190,43,128,85,164,111,159,40,37,145,139,33,13,172,67,25,109,141,35,32,56,92,174,78,171,152,57,186,113,196,89,162,198,28,74,4,97,131,0,199,62,44,34,108,6,21,155,184,161,80,58,177,169,191,11,104,180,163,170,95,31,90,125,149,120,68,63,100,116,175,176,193,16,136,144,70,19,64,103,112,84,77,115,179,60,42,47,132,165,119,48];442;False
3951;7008;10959;[174,9,117,22,26,138,176,3,2,130,187,12,77,132,193,109,66,157,103,105,45,188,93,87,6,149,167,61,194,21,146,72,78,128,42,57,37,121,162,126,143,160,84,1,33,124,94,196,36,182,140,178,147,23,189,81,0,85,104,31,74,20,19,144,170,95,38,139,165,46,51,50,180,118,136,123,82,67,32,91,163,25,70,65,16,190,11,113,156,71,8,184,34,191,173,18,131,110,101,59,80,100,30,134,148,195,97,58,175,151,7,102,181,68,198,142,137,158,54,52,119,49,39,107,55,14,13,111,112,89,75,154,15,135,53,183,69,159,164,41,28,155,73,99,106,4,115,152,35,161,172,86,133,76,122,116,44,125,145,56,92,108,192,40,169,129,29,90,60,177,27,43,127,96,171,141,98,114,64,79,179,47,88,5,186,199,83,153,166,24,150,10,185,62,120,197,168,17,48,63];443;False
1960;8213;10173;[189,55,166,91,88,5,27,147,9,150,99,73,140,178,192,10,123,17,8,94,173,18,158,129,24,197,15,135,14,49,195,194,182,65,124,46,130,22,38,105,72,154,75,151,7,153,187,127,39,107,76,122,102,114,101,110,30,134,137,86,181,82,23,12,54,142,121,168,3,98,117,2,81,52,106,118,183,83,26,79,185,148,167,61,59,36,1,93,41,133,96,157,138,45,188,87,66,126,20,146,50,53,51,29,143,156,160,71,69,190,43,128,85,164,111,159,40,37,145,139,33,13,172,67,25,109,141,35,32,56,92,174,78,171,152,57,186,113,196,89,162,198,28,74,4,97,131,0,199,62,44,34,108,6,21,155,184,161,80,58,177,169,191,11,104,180,163,170,95,31,90,125,149,120,68,63,100,116,175,176,193,16,136,144,70,19,64,103,112,84,77,115,179,60,42,47,132,165,119,48];444;False
3923;7008;10931;[174,41,117,22,26,138,176,3,2,130,187,12,77,132,193,109,66,157,103,105,45,188,93,87,6,149,167,61,194,21,146,72,78,128,42,57,37,121,162,126,143,160,84,1,33,124,94,196,36,182,140,178,147,23,189,81,0,85,104,31,74,20,19,144,170,95,38,139,165,46,51,50,180,118,136,123,82,67,32,91,163,25,70,65,16,190,11,113,156,71,8,184,34,191,173,18,131,110,101,59,80,100,30,134,148,195,97,58,175,151,7,102,181,68,198,142,137,158,54,52,119,49,39,107,55,14,13,111,112,89,75,154,15,135,53,183,69,159,164,9,28,155,73,99,106,4,115,152,35,161,172,86,133,76,122,116,44,125,145,56,92,108,192,40,169,129,29,90,60,177,27,43,127,96,171,141,98,114,64,79,179,47,88,5,186,199,83,153,166,24,150,10,185,62,120,197,168,17,48,63];445;False
1933;8233;10166;[189,55,166,91,88,5,27,147,9,150,99,73,140,178,192,10,123,17,8,94,173,18,158,129,162,197,15,135,14,49,195,194,182,65,124,46,130,22,38,105,72,154,75,151,7,153,187,127,39,107,76,122,102,114,101,110,30,134,137,86,181,82,23,12,54,142,121,168,3,98,117,2,81,52,106,118,183,83,26,79,185,148,167,61,59,36,1,93,41,133,96,157,138,45,188,87,66,126,20,146,50,53,51,29,143,156,160,71,69,190,43,128,85,164,111,159,40,37,145,139,33,13,172,67,25,109,141,35,32,56,92,174,78,171,152,57,186,113,196,89,24,198,28,74,4,97,131,0,199,62,44,34,108,6,21,155,184,161,80,58,177,169,191,11,104,180,163,170,95,31,90,125,149,120,68,63,100,116,175,176,193,16,136,144,70,19,64,103,112,84,77,115,179,60,42,47,132,165,119,48];446;False
3904;7002;10906;[180,41,117,22,26,138,176,3,2,130,187,12,77,132,193,109,66,157,103,105,45,188,93,87,6,149,167,61,194,21,146,72,78,128,42,57,37,121,162,126,143,160,84,1,33,124,94,196,36,182,140,178,147,23,189,81,0,85,104,31,74,20,19,144,170,95,38,139,165,46,51,50,174,118,136,123,82,67,32,91,163,25,70,65,16,190,11,113,156,71,8,184,34,191,173,18,131,110,101,59,80,100,30,134,148,195,97,58,175,151,7,102,181,68,198,142,137,158,54,52,119,49,39,107,55,14,13,111,112,89,75,154,15,135,53,183,69,159,164,9,28,155,73,99,106,4,115,152,35,161,172,86,133,76,122,116,44,125,145,56,92,108,192,40,169,129,29,90,60,177,27,43,127,96,171,141,98,114,64,79,179,47,88,5,186,199,83,153,166,24,150,10,185,62,120,197,168,17,48,63];447;False
1943;8216;10159;[139,55,166,91,88,5,27,147,9,150,99,73,140,178,192,10,123,17,8,94,173,18,158,129,162,197,15,135,14,49,195,194,182,65,124,46,130,22,38,105,72,154,75,151,7,153,187,127,39,107,76,122,102,114,101,110,30,134,137,86,181,82,23,12,54,142,121,168,3,98,117,2,81,52,106,118,183,83,26,79,185,148,167,61,59,36,1,93,41,133,96,157,138,45,188,87,66,126,20,146,50,53,51,29,143,156,160,71,69,190,43,128,85,164,111,159,40,37,145,189,33,13,172,67,25,109,141,35,32,56,92,174,78,171,152,57,186,113,196,89,24,198,28,74,4,97,131,0,199,62,44,34,108,6,21,155,184,161,80,58,177,169,191,11,104,180,163,170,95,31,90,125,149,120,68,63,100,116,175,176,193,16,136,144,70,19,64,103,112,84,77,115,179,60,42,47,132,165,119,48];448;False
3947;6984;10931;[34,41,117,22,26,138,176,3,2,130,187,12,77,132,193,109,66,157,103,105,45,188,93,87,6,149,167,61,194,21,146,72,78,128,42,57,37,121,162,126,143,160,84,1,33,124,94,196,36,182,140,178,147,23,189,81,0,85,104,31,74,20,19,144,170,95,38,139,165,46,51,50,174,118,136,123,82,67,32,91,163,25,70,65,16,190,11,113,156,71,8,184,180,191,173,18,131,110,101,59,80,100,30,134,148,195,97,58,175,151,7,102,181,68,198,142,137,158,54,52,119,49,39,107,55,14,13,111,112,89,75,154,15,135,53,183,69,159,164,9,28,155,73,99,106,4,115,152,35,161,172,86,133,76,122,116,44,125,145,56,92,108,192,40,169,129,29,90,60,177,27,43,127,96,171,141,98,114,64,79,179,47,88,5,186,199,83,153,166,24,150,10,185,62,120,197,168,17,48,63];449;False
1953;8212;10165;[105,55,166,91,88,5,27,147,9,150,99,73,140,178,192,10,123,17,8,94,173,18,158,129,162,197,15,135,14,49,195,194,182,65,124,46,130,22,38,139,72,154,75,151,7,153,187,127,39,107,76,122,102,114,101,110,30,134,137,86,181,82,23,12,54,142,121,168,3,98,117,2,81,52,106,118,183,83,26,79,185,148,167,61,59,36,1,93,41,133,96,157,138,45,188,87,66,126,20,146,50,53,51,29,143,156,160,71,69,190,43,128,85,164,111,159,40,37,145,189,33,13,172,67,25,109,141,35,32,56,92,174,78,171,152,57,186,113,196,89,24,198,28,74,4,97,131,0,199,62,44,34,108,6,21,155,184,161,80,58,177,169,191,11,104,180,163,170,95,31,90,125,149,120,68,63,100,116,175,176,193,16,136,144,70,19,64,103,112,84,77,115,179,60,42,47,132,165,119,48];450;False
3922;6989;10911;[34,130,117,22,26,138,176,3,2,41,187,12,77,132,193,109,66,157,103,105,45,188,93,87,6,149,167,61,194,21,146,72,78,128,42,57,37,121,162,126,143,160,84,1,33,124,94,196,36,182,140,178,147,23,189,81,0,85,104,31,74,20,19,144,170,95,38,139,165,46,51,50,174,118,136,123,82,67,32,91,163,25,70,65,16,190,11,113,156,71,8,184,180,191,173,18,131,110,101,59,80,100,30,134,148,195,97,58,175,151,7,102,181,68,198,142,137,158,54,52,119,49,39,107,55,14,13,111,112,89,75,154,15,135,53,183,69,159,164,9,28,155,73,99,106,4,115,152,35,161,172,86,133,76,122,116,44,125,145,56,92,108,192,40,169,129,29,90,60,177,27,43,127,96,171,141,98,114,64,79,179,47,88,5,186,199,83,153,166,24,150,10,185,62,120,197,168,17,48,63];451;False
1875;8227;10102;[150,55,166,91,88,5,27,147,9,105,99,73,140,178,192,10,123,17,8,94,173,18,158,129,162,197,15,135,14,49,195,194,182,65,124,46,130,22,38,139,72,154,75,151,7,153,187,127,39,107,76,122,102,114,101,110,30,134,137,86,181,82,23,12,54,142,121,168,3,98,117,2,81,52,106,118,183,83,26,79,185,148,167,61,59,36,1,93,41,133,96,157,138,45,188,87,66,126,20,146,50,53,51,29,143,156,160,71,69,190,43,128,85,164,111,159,40,37,145,189,33,13,172,67,25,109,141,35,32,56,92,174,78,171,152,57,186,113,196,89,24,198,28,74,4,97,131,0,199,62,44,34,108,6,21,155,184,161,80,58,177,169,191,11,104,180,163,170,95,31,90,125,149,120,68,63,100,116,175,176,193,16,136,144,70,19,64,103,112,84,77,115,179,60,42,47,132,165,119,48];452;False
3901;7005;10906;[146,130,117,22,26,138,176,3,2,41,187,12,77,132,193,109,66,157,103,105,45,188,93,87,6,149,167,61,194,21,34,72,78,128,42,57,37,121,162,126,143,160,84,1,33,124,94,196,36,182,140,178,147,23,189,81,0,85,104,31,74,20,19,144,170,95,38,139,165,46,51,50,174,118,136,123,82,67,32,91,163,25,70,65,16,190,11,113,156,71,8,184,180,191,173,18,131,110,101,59,80,100,30,134,148,195,97,58,175,151,7,102,181,68,198,142,137,158,54,52,119,49,39,107,55,14,13,111,112,89,75,154,15,135,53,183,69,159,164,9,28,155,73,99,106,4,115,152,35,161,172,86,133,76,122,116,44,125,145,56,92,108,192,40,169,129,29,90,60,177,27,43,127,96,171,141,98,114,64,79,179,47,88,5,186,199,83,153,166,24,150,10,185,62,120,197,168,17,48,63];453;False
1928;8209;10137;[147,55,166,91,88,5,27,150,9,105,99,73,140,178,192,10,123,17,8,94,173,18,158,129,162,197,15,135,14,49,195,194,182,65,124,46,130,22,38,139,72,154,75,151,7,153,187,127,39,107,76,122,102,114,101,110,30,134,137,86,181,82,23,12,54,142,121,168,3,98,117,2,81,52,106,118,183,83,26,79,185,148,167,61,59,36,1,93,41,133,96,157,138,45,188,87,66,126,20,146,50,53,51,29,143,156,160,71,69,190,43,128,85,164,111,159,40,37,145,189,33,13,172,67,25,109,141,35,32,56,92,174,78,171,152,57,186,113,196,89,24,198,28,74,4,97,131,0,199,62,44,34,108,6,21,155,184,161,80,58,177,169,191,11,104,180,163,170,95,31,90,125,149,120,68,63,100,116,175,176,193,16,136,144,70,19,64,103,112,84,77,115,179,60,42,47,132,165,119,48];454;False
3776;7006;10782;[194,130,117,22,26,138,176,3,2,41,187,12,77,132,193,109,66,157,103,105,45,188,93,87,6,149,167,61,146,21,34,72,78,128,42,57,37,121,162,126,143,160,84,1,33,124,94,196,36,182,140,178,147,23,189,81,0,85,104,31,74,20,19,144,170,95,38,139,165,46,51,50,174,118,136,123,82,67,32,91,163,25,70,65,16,190,11,113,156,71,8,184,180,191,173,18,131,110,101,59,80,100,30,134,148,195,97,58,175,151,7,102,181,68,198,142,137,158,54,52,119,49,39,107,55,14,13,111,112,89,75,154,15,135,53,183,69,159,164,9,28,155,73,99,106,4,115,152,35,161,172,86,133,76,122,116,44,125,145,56,92,108,192,40,169,129,29,90,60,177,27,43,127,96,171,141,98,114,64,79,179,47,88,5,186,199,83,153,166,24,150,10,185,62,120,197,168,17,48,63];455;False
1925;8207;10132;[46,55,166,91,88,5,27,150,9,105,99,73,140,178,192,10,123,17,8,94,173,18,158,129,162,197,15,135,14,49,195,194,182,65,124,147,130,22,38,139,72,154,75,151,7,153,187,127,39,107,76,122,102,114,101,110,30,134,137,86,181,82,23,12,54,142,121,168,3,98,117,2,81,52,106,118,183,83,26,79,185,148,167,61,59,36,1,93,41,133,96,157,138,45,188,87,66,126,20,146,50,53,51,29,143,156,160,71,69,190,43,128,85,164,111,159,40,37,145,189,33,13,172,67,25,109,141,35,32,56,92,174,78,171,152,57,186,113,196,89,24,198,28,74,4,97,131,0,199,62,44,34,108,6,21,155,184,161,80,58,177,169,191,11,104,180,163,170,95,31,90,125,149,120,68,63,100,116,175,176,193,16,136,144,70,19,64,103,112,84,77,115,179,60,42,47,132,165,119,48];456;False
3742;7011;10753;[180,130,117,22,26,138,176,3,2,41,187,12,77,132,193,109,66,157,103,105,45,188,93,87,6,149,167,61,146,21,34,72,78,128,42,57,37,121,162,126,143,160,84,1,33,124,94,196,36,182,140,178,147,23,189,81,0,85,104,31,74,20,19,144,170,95,38,139,165,46,51,50,174,118,136,123,82,67,32,91,163,25,70,65,16,190,11,113,156,71,8,184,194,191,173,18,131,110,101,59,80,100,30,134,148,195,97,58,175,151,7,102,181,68,198,142,137,158,54,52,119,49,39,107,55,14,13,111,112,89,75,154,15,135,53,183,69,159,164,9,28,155,73,99,106,4,115,152,35,161,172,86,133,76,122,116,44,125,145,56,92,108,192,40,169,129,29,90,60,177,27,43,127,96,171,141,98,114,64,79,179,47,88,5,186,199,83,153,166,24,150,10,185,62,120,197,168,17,48,63];457;False
1920;8209;10129;[55,46,166,91,88,5,27,150,9,105,99,73,140,178,192,10,123,17,8,94,173,18,158,129,162,197,15,135,14,49,195,194,182,65,124,147,130,22,38,139,72,154,75,151,7,153,187,127,39,107,76,122,102,114,101,110,30,134,137,86,181,82,23,12,54,142,121,168,3,98,117,2,81,52,106,118,183,83,26,79,185,148,167,61,59,36,1,93,41,133,96,157,138,45,188,87,66,126,20,146,50,53,51,29,143,156,160,71,69,190,43,128,85,164,111,159,40,37,145,189,33,13,172,67,25,109,141,35,32,56,92,174,78,171,152,57,186,113,196,89,24,198,28,74,4,97,131,0,199,62,44,34,108,6,21,155,184,161,80,58,177,169,191,11,104,180,163,170,95,31,90,125,149,120,68,63,100,116,175,176,193,16,136,144,70,19,64,103,112,84,77,115,179,60,42,47,132,165,119,48];458;False
1948;8191;10139;[143,55,166,91,88,5,27,150,9,105,99,73,140,178,192,10,123,17,8,94,173,18,158,129,162,197,15,135,14,49,195,194,182,65,124,147,130,22,38,139,72,154,75,151,7,153,187,127,39,107,76,122,102,114,101,110,30,134,137,86,181,82,23,12,54,142,121,168,3,98,117,2,81,52,106,118,183,83,26,79,185,148,167,61,59,36,1,93,41,133,96,157,138,45,188,87,66,126,20,146,50,53,51,29,46,156,160,71,69,190,43,128,85,164,111,159,40,37,145,189,33,13,172,67,25,109,141,35,32,56,92,174,78,171,152,57,186,113,196,89,24,198,28,74,4,97,131,0,199,62,44,34,108,6,21,155,184,161,80,58,177,169,191,11,104,180,163,170,95,31,90,125,149,120,68,63,100,116,175,176,193,16,136,144,70,19,64,103,112,84,77,115,179,60,42,47,132,165,119,48];459;False
3722;7009;10731;[34,130,117,22,26,138,176,3,2,41,187,12,77,132,193,109,66,157,103,105,45,188,93,87,6,149,167,61,146,21,180,72,78,128,42,57,37,121,162,126,143,160,84,1,33,124,94,196,36,182,140,178,147,23,189,81,0,85,104,31,74,20,19,144,170,95,38,139,165,46,51,50,174,118,136,123,82,67,32,91,163,25,70,65,16,190,11,113,156,71,8,184,194,191,173,18,131,110,101,59,80,100,30,134,148,195,97,58,175,151,7,102,181,68,198,142,137,158,54,52,119,49,39,107,55,14,13,111,112,89,75,154,15,135,53,183,69,159,164,9,28,155,73,99,106,4,115,152,35,161,172,86,133,76,122,116,44,125,145,56,92,108,192,40,169,129,29,90,60,177,27,43,127,96,171,141,98,114,64,79,179,47,88,5,186,199,83,153,166,24,150,10,185,62,120,197,168,17,48,63];460;False
1932;8182;10114;[174,46,166,91,88,5,27,150,9,105,99,73,140,178,192,10,123,17,8,94,173,18,158,129,162,197,15,135,14,49,195,194,182,65,124,147,130,22,38,139,72,154,75,151,7,153,187,127,39,107,76,122,102,114,101,110,30,134,137,86,181,82,23,12,54,142,121,168,3,98,117,2,81,52,106,118,183,83,26,79,185,148,167,61,59,36,1,93,41,133,96,157,138,45,188,87,66,126,20,146,50,53,51,29,143,156,160,71,69,190,43,128,85,164,111,159,40,37,145,189,33,13,172,67,25,109,141,35,32,56,92,55,78,171,152,57,186,113,196,89,24,198,28,74,4,97,131,0,199,62,44,34,108,6,21,155,184,161,80,58,177,169,191,11,104,180,163,170,95,31,90,125,149,120,68,63,100,116,175,176,193,16,136,144,70,19,64,103,112,84,77,115,179,60,42,47,132,165,119,48];461;False
3696;7023;10719;[178,130,117,22,26,138,176,3,2,41,187,12,77,132,193,109,66,157,103,105,45,188,93,87,6,149,167,61,146,21,180,72,78,128,42,57,37,121,162,126,143,160,84,1,33,124,94,196,36,182,140,34,147,23,189,81,0,85,104,31,74,20,19,144,170,95,38,139,165,46,51,50,174,118,136,123,82,67,32,91,163,25,70,65,16,190,11,113,156,71,8,184,194,191,173,18,131,110,101,59,80,100,30,134,148,195,97,58,175,151,7,102,181,68,198,142,137,158,54,52,119,49,39,107,55,14,13,111,112,89,75,154,15,135,53,183,69,159,164,9,28,155,73,99,106,4,115,152,35,161,172,86,133,76,122,116,44,125,145,56,92,108,192,40,169,129,29,90,60,177,27,43,127,96,171,141,98,114,64,79,179,47,88,5,186,199,83,153,166,24,150,10,185,62,120,197,168,17,48,63];462;False
1910;8226;10136;[36,46,166,91,88,5,27,150,9,105,99,73,140,178,192,10,123,17,8,94,173,18,158,129,162,197,15,135,14,49,195,194,182,65,124,147,130,22,38,139,72,154,75,151,7,153,187,127,39,107,76,122,102,114,101,110,30,134,137,86,181,82,23,12,54,142,121,168,3,98,117,2,81,52,106,118,183,83,26,79,185,148,167,61,59,174,1,93,41,133,96,157,138,45,188,87,66,126,20,146,50,53,51,29,143,156,160,71,69,190,43,128,85,164,111,159,40,37,145,189,33,13,172,67,25,109,141,35,32,56,92,55,78,171,152,57,186,113,196,89,24,198,28,74,4,97,131,0,199,62,44,34,108,6,21,155,184,161,80,58,177,169,191,11,104,180,163,170,95,31,90,125,149,120,68,63,100,116,175,176,193,16,136,144,70,19,64,103,112,84,77,115,179,60,42,47,132,165,119,48];463;False
3709;7020;10729;[138,130,117,22,26,178,176,3,2,41,187,12,77,132,193,109,66,157,103,105,45,188,93,87,6,149,167,61,146,21,180,72,78,128,42,57,37,121,162,126,143,160,84,1,33,124,94,196,36,182,140,34,147,23,189,81,0,85,104,31,74,20,19,144,170,95,38,139,165,46,51,50,174,118,136,123,82,67,32,91,163,25,70,65,16,190,11,113,156,71,8,184,194,191,173,18,131,110,101,59,80,100,30,134,148,195,97,58,175,151,7,102,181,68,198,142,137,158,54,52,119,49,39,107,55,14,13,111,112,89,75,154,15,135,53,183,69,159,164,9,28,155,73,99,106,4,115,152,35,161,172,86,133,76,122,116,44,125,145,56,92,108,192,40,169,129,29,90,60,177,27,43,127,96,171,141,98,114,64,79,179,47,88,5,186,199,83,153,166,24,150,10,185,62,120,197,168,17,48,63];464;False
1918;8214;10132;[36,46,166,91,88,5,27,150,160,105,99,73,140,178,192,10,123,17,8,94,173,18,158,129,162,197,15,135,14,49,195,194,182,65,124,147,130,22,38,139,72,154,75,151,7,153,187,127,39,107,76,122,102,114,101,110,30,134,137,86,181,82,23,12,54,142,121,168,3,98,117,2,81,52,106,118,183,83,26,79,185,148,167,61,59,174,1,93,41,133,96,157,138,45,188,87,66,126,20,146,50,53,51,29,143,156,9,71,69,190,43,128,85,164,111,159,40,37,145,189,33,13,172,67,25,109,141,35,32,56,92,55,78,171,152,57,186,113,196,89,24,198,28,74,4,97,131,0,199,62,44,34,108,6,21,155,184,161,80,58,177,169,191,11,104,180,163,170,95,31,90,125,149,120,68,63,100,116,175,176,193,16,136,144,70,19,64,103,112,84,77,115,179,60,42,47,132,165,119,48];465;False
3628;7048;10676;[176,130,117,22,26,178,138,3,2,41,187,12,77,132,193,109,66,157,103,105,45,188,93,87,6,149,167,61,146,21,180,72,78,128,42,57,37,121,162,126,143,160,84,1,33,124,94,196,36,182,140,34,147,23,189,81,0,85,104,31,74,20,19,144,170,95,38,139,165,46,51,50,174,118,136,123,82,67,32,91,163,25,70,65,16,190,11,113,156,71,8,184,194,191,173,18,131,110,101,59,80,100,30,134,148,195,97,58,175,151,7,102,181,68,198,142,137,158,54,52,119,49,39,107,55,14,13,111,112,89,75,154,15,135,53,183,69,159,164,9,28,155,73,99,106,4,115,152,35,161,172,86,133,76,122,116,44,125,145,56,92,108,192,40,169,129,29,90,60,177,27,43,127,96,171,141,98,114,64,79,179,47,88,5,186,199,83,153,166,24,150,10,185,62,120,197,168,17,48,63];466;False
1940;8170;10110;[174,46,166,91,88,5,27,150,160,105,99,73,140,178,192,10,123,17,8,94,173,18,158,129,162,197,15,135,14,49,195,194,182,65,124,147,130,22,38,139,72,154,75,151,7,153,187,127,39,107,76,122,102,114,101,110,30,134,137,86,181,82,23,12,54,142,121,168,3,98,117,2,81,52,106,118,183,83,26,79,185,148,167,61,59,36,1,93,41,133,96,157,138,45,188,87,66,126,20,146,50,53,51,29,143,156,9,71,69,190,43,128,85,164,111,159,40,37,145,189,33,13,172,67,25,109,141,35,32,56,92,55,78,171,152,57,186,113,196,89,24,198,28,74,4,97,131,0,199,62,44,34,108,6,21,155,184,161,80,58,177,169,191,11,104,180,163,170,95,31,90,125,149,120,68,63,100,116,175,176,193,16,136,144,70,19,64,103,112,84,77,115,179,60,42,47,132,165,119,48];467;False
3645;7027;10672;[178,130,117,22,26,176,138,3,2,41,187,12,77,132,193,109,66,157,103,105,45,188,93,87,6,149,167,61,146,21,180,72,78,128,42,57,37,121,162,126,143,160,84,1,33,124,94,196,36,182,140,34,147,23,189,81,0,85,104,31,74,20,19,144,170,95,38,139,165,46,51,50,174,118,136,123,82,67,32,91,163,25,70,65,16,190,11,113,156,71,8,184,194,191,173,18,131,110,101,59,80,100,30,134,148,195,97,58,175,151,7,102,181,68,198,142,137,158,54,52,119,49,39,107,55,14,13,111,112,89,75,154,15,135,53,183,69,159,164,9,28,155,73,99,106,4,115,152,35,161,172,86,133,76,122,116,44,125,145,56,92,108,192,40,169,129,29,90,60,177,27,43,127,96,171,141,98,114,64,79,179,47,88,5,186,199,83,153,166,24,150,10,185,62,120,197,168,17,48,63];468;False
1928;8197;10125;[55,46,166,91,88,5,27,150,160,105,99,73,140,178,192,10,123,17,8,94,173,18,158,129,162,197,15,135,14,49,195,194,182,65,124,147,130,22,38,139,72,154,75,151,7,153,187,127,39,107,76,122,102,114,101,110,30,134,137,86,181,82,23,12,54,142,121,168,3,98,117,2,81,52,106,118,183,83,26,79,185,148,167,61,59,36,1,93,41,133,96,157,138,45,188,87,66,126,20,146,50,53,51,29,143,156,9,71,69,190,43,128,85,164,111,159,40,37,145,189,33,13,172,67,25,109,141,35,32,56,92,174,78,171,152,57,186,113,196,89,24,198,28,74,4,97,131,0,199,62,44,34,108,6,21,155,184,161,80,58,177,169,191,11,104,180,163,170,95,31,90,125,149,120,68,63,100,116,175,176,193,16,136,144,70,19,64,103,112,84,77,115,179,60,42,47,132,165,119,48];469;False
3683;7018;10701;[138,130,117,22,26,176,178,3,2,41,187,12,77,132,193,109,66,157,103,105,45,188,93,87,6,149,167,61,146,21,180,72,78,128,42,57,37,121,162,126,143,160,84,1,33,124,94,196,36,182,140,34,147,23,189,81,0,85,104,31,74,20,19,144,170,95,38,139,165,46,51,50,174,118,136,123,82,67,32,91,163,25,70,65,16,190,11,113,156,71,8,184,194,191,173,18,131,110,101,59,80,100,30,134,148,195,97,58,175,151,7,102,181,68,198,142,137,158,54,52,119,49,39,107,55,14,13,111,112,89,75,154,15,135,53,183,69,159,164,9,28,155,73,99,106,4,115,152,35,161,172,86,133,76,122,116,44,125,145,56,92,108,192,40,169,129,29,90,60,177,27,43,127,96,171,141,98,114,64,79,179,47,88,5,186,199,83,153,166,24,150,10,185,62,120,197,168,17,48,63];470;False
1925;8206;10131;[55,46,166,91,88,5,27,150,160,105,99,73,140,178,192,10,123,17,8,94,173,18,158,129,162,197,15,135,14,49,195,194,182,65,124,147,130,22,38,139,72,1,75,151,7,153,187,127,39,107,76,122,102,114,101,110,30,134,137,86,181,82,23,12,54,142,121,168,3,98,117,2,81,52,106,118,183,83,26,79,185,148,167,61,59,36,154,93,41,133,96,157,138,45,188,87,66,126,20,146,50,53,51,29,143,156,9,71,69,190,43,128,85,164,111,159,40,37,145,189,33,13,172,67,25,109,141,35,32,56,92,174,78,171,152,57,186,113,196,89,24,198,28,74,4,97,131,0,199,62,44,34,108,6,21,155,184,161,80,58,177,169,191,11,104,180,163,170,95,31,90,125,149,120,68,63,100,116,175,176,193,16,136,144,70,19,64,103,112,84,77,115,179,60,42,47,132,165,119,48];471;False
3616;7043;10659;[176,130,117,22,26,138,178,3,2,41,187,12,77,132,193,109,66,157,103,105,45,188,93,87,6,149,167,61,146,21,180,72,78,128,42,57,37,121,162,126,143,160,84,1,33,124,94,196,36,182,140,34,147,23,189,81,0,85,104,31,74,20,19,144,170,95,38,139,165,46,51,50,174,118,136,123,82,67,32,91,163,25,70,65,16,190,11,113,156,71,8,184,194,191,173,18,131,110,101,59,80,100,30,134,148,195,97,58,175,151,7,102,181,68,198,142,137,158,54,52,119,49,39,107,55,14,13,111,112,89,75,154,15,135,53,183,69,159,164,9,28,155,73,99,106,4,115,152,35,161,172,86,133,76,122,116,44,125,145,56,92,108,192,40,169,129,29,90,60,177,27,43,127,96,171,141,98,114,64,79,179,47,88,5,186,199,83,153,166,24,150,10,185,62,120,197,168,17,48,63];472;False
1937;8179;10116;[174,46,166,91,88,5,27,150,160,105,99,73,140,178,192,10,123,17,8,94,173,18,158,129,162,197,15,135,14,49,195,194,182,65,124,147,130,22,38,139,72,1,75,151,7,153,187,127,39,107,76,122,102,114,101,110,30,134,137,86,181,82,23,12,54,142,121,168,3,98,117,2,81,52,106,118,183,83,26,79,185,148,167,61,59,36,154,93,41,133,96,157,138,45,188,87,66,126,20,146,50,53,51,29,143,156,9,71,69,190,43,128,85,164,111,159,40,37,145,189,33,13,172,67,25,109,141,35,32,56,92,55,78,171,152,57,186,113,196,89,24,198,28,74,4,97,131,0,199,62,44,34,108,6,21,155,184,161,80,58,177,169,191,11,104,180,163,170,95,31,90,125,149,120,68,63,100,116,175,176,193,16,136,144,70,19,64,103,112,84,77,115,179,60,42,47,132,165,119,48];473;False
3565;7055;10620;[117,130,176,22,26,138,178,3,2,41,187,12,77,132,193,109,66,157,103,105,45,188,93,87,6,149,167,61,146,21,180,72,78,128,42,57,37,121,162,126,143,160,84,1,33,124,94,196,36,182,140,34,147,23,189,81,0,85,104,31,74,20,19,144,170,95,38,139,165,46,51,50,174,118,136,123,82,67,32,91,163,25,70,65,16,190,11,113,156,71,8,184,194,191,173,18,131,110,101,59,80,100,30,134,148,195,97,58,175,151,7,102,181,68,198,142,137,158,54,52,119,49,39,107,55,14,13,111,112,89,75,154,15,135,53,183,69,159,164,9,28,155,73,99,106,4,115,152,35,161,172,86,133,76,122,116,44,125,145,56,92,108,192,40,169,129,29,90,60,177,27,43,127,96,171,141,98,114,64,79,179,47,88,5,186,199,83,153,166,24,150,10,185,62,120,197,168,17,48,63];474;False
1929;8191;10120;[174,46,166,91,88,5,27,150,9,105,99,73,140,178,192,10,123,17,8,94,173,18,158,129,162,197,15,135,14,49,195,194,182,65,124,147,130,22,38,139,72,1,75,151,7,153,187,127,39,107,76,122,102,114,101,110,30,134,137,86,181,82,23,12,54,142,121,168,3,98,117,2,81,52,106,118,183,83,26,79,185,148,167,61,59,36,154,93,41,133,96,157,138,45,188,87,66,126,20,146,50,53,51,29,143,156,160,71,69,190,43,128,85,164,111,159,40,37,145,189,33,13,172,67,25,109,141,35,32,56,92,55,78,171,152,57,186,113,196,89,24,198,28,74,4,97,131,0,199,62,44,34,108,6,21,155,184,161,80,58,177,169,191,11,104,180,163,170,95,31,90,125,149,120,68,63,100,116,175,176,193,16,136,144,70,19,64,103,112,84,77,115,179,60,42,47,132,165,119,48];475;False
3593;7039;10632;[130,117,176,22,26,138,178,3,2,41,187,12,77,132,193,109,66,157,103,105,45,188,93,87,6,149,167,61,146,21,180,72,78,128,42,57,37,121,162,126,143,160,84,1,33,124,94,196,36,182,140,34,147,23,189,81,0,85,104,31,74,20,19,144,170,95,38,139,165,46,51,50,174,118,136,123,82,67,32,91,163,25,70,65,16,190,11,113,156,71,8,184,194,191,173,18,131,110,101,59,80,100,30,134,148,195,97,58,175,151,7,102,181,68,198,142,137,158,54,52,119,49,39,107,55,14,13,111,112,89,75,154,15,135,53,183,69,159,164,9,28,155,73,99,106,4,115,152,35,161,172,86,133,76,122,116,44,125,145,56,92,108,192,40,169,129,29,90,60,177,27,43,127,96,171,141,98,114,64,79,179,47,88,5,186,199,83,153,166,24,150,10,185,62,120,197,168,17,48,63];476;False
3624;7029;10653;[3,130,176,22,26,138,178,117,2,41,187,12,77,132,193,109,66,157,103,105,45,188,93,87,6,149,167,61,146,21,180,72,78,128,42,57,37,121,162,126,143,160,84,1,33,124,94,196,36,182,140,34,147,23,189,81,0,85,104,31,74,20,19,144,170,95,38,139,165,46,51,50,174,118,136,123,82,67,32,91,163,25,70,65,16,190,11,113,156,71,8,184,194,191,173,18,131,110,101,59,80,100,30,134,148,195,97,58,175,151,7,102,181,68,198,142,137,158,54,52,119,49,39,107,55,14,13,111,112,89,75,154,15,135,53,183,69,159,164,9,28,155,73,99,106,4,115,152,35,161,172,86,133,76,122,116,44,125,145,56,92,108,192,40,169,129,29,90,60,177,27,43,127,96,171,141,98,114,64,79,179,47,88,5,186,199,83,153,166,24,150,10,185,62,120,197,168,17,48,63];477;False
1917;8218;10135;[55,46,166,91,88,5,27,150,9,105,99,73,140,178,192,10,123,17,8,94,173,18,158,129,162,197,15,135,14,49,195,194,182,65,124,147,130,22,38,139,72,1,75,151,7,153,187,127,39,107,76,122,102,114,101,110,30,134,137,86,181,82,23,12,54,142,121,168,3,98,117,2,81,52,106,118,183,83,26,79,185,148,167,61,59,36,154,93,41,133,96,157,138,45,188,87,66,126,20,146,50,53,51,29,143,156,160,71,69,190,43,128,85,164,111,159,40,37,145,189,33,13,172,67,25,109,141,35,32,56,92,174,78,171,152,57,186,113,196,89,24,198,28,74,4,97,131,0,199,62,44,34,108,6,21,155,184,161,80,58,177,169,191,11,104,180,163,170,95,31,90,125,149,120,68,63,100,116,175,176,193,16,136,144,70,19,64,103,112,84,77,115,179,60,42,47,132,165,119,48];478;False
3613;7034;10647;[41,117,176,22,26,138,178,3,2,130,187,12,77,132,193,109,66,157,103,105,45,188,93,87,6,149,167,61,146,21,180,72,78,128,42,57,37,121,162,126,143,160,84,1,33,124,94,196,36,182,140,34,147,23,189,81,0,85,104,31,74,20,19,144,170,95,38,139,165,46,51,50,174,118,136,123,82,67,32,91,163,25,70,65,16,190,11,113,156,71,8,184,194,191,173,18,131,110,101,59,80,100,30,134,148,195,97,58,175,151,7,102,181,68,198,142,137,158,54,52,119,49,39,107,55,14,13,111,112,89,75,154,15,135,53,183,69,159,164,9,28,155,73,99,106,4,115,152,35,161,172,86,133,76,122,116,44,125,145,56,92,108,192,40,169,129,29,90,60,177,27,43,127,96,171,141,98,114,64,79,179,47,88,5,186,199,83,153,166,24,150,10,185,62,120,197,168,17,48,63];479;False
3578;7049;10627;[187,130,176,22,26,138,178,117,2,41,3,12,77,132,193,109,66,157,103,105,45,188,93,87,6,149,167,61,146,21,180,72,78,128,42,57,37,121,162,126,143,160,84,1,33,124,94,196,36,182,140,34,147,23,189,81,0,85,104,31,74,20,19,144,170,95,38,139,165,46,51,50,174,118,136,123,82,67,32,91,163,25,70,65,16,190,11,113,156,71,8,184,194,191,173,18,131,110,101,59,80,100,30,134,148,195,97,58,175,151,7,102,181,68,198,142,137,158,54,52,119,49,39,107,55,14,13,111,112,89,75,154,15,135,53,183,69,159,164,9,28,155,73,99,106,4,115,152,35,161,172,86,133,76,122,116,44,125,145,56,92,108,192,40,169,129,29,90,60,177,27,43,127,96,171,141,98,114,64,79,179,47,88,5,186,199,83,153,166,24,150,10,185,62,120,197,168,17,48,63];480;False
1923;8204;10127;[55,46,166,174,88,5,27,150,9,105,99,73,140,178,192,10,123,17,8,94,173,18,158,129,162,197,15,135,14,49,195,194,182,65,124,147,130,22,38,139,72,1,75,151,7,153,187,127,39,107,76,122,102,114,101,110,30,134,137,86,181,82,23,12,54,142,121,168,3,98,117,2,81,52,106,118,183,83,26,79,185,148,167,61,59,36,154,93,41,133,96,157,138,45,188,87,66,126,20,146,50,53,51,29,143,156,160,71,69,190,43,128,85,164,111,159,40,37,145,189,33,13,172,67,25,109,141,35,32,56,92,91,78,171,152,57,186,113,196,89,24,198,28,74,4,97,131,0,199,62,44,34,108,6,21,155,184,161,80,58,177,169,191,11,104,180,163,170,95,31,90,125,149,120,68,63,100,116,175,176,193,16,136,144,70,19,64,103,112,84,77,115,179,60,42,47,132,165,119,48];481;False
3589;7047;10636;[146,117,176,22,26,138,178,3,2,130,187,12,77,132,193,109,66,157,103,105,45,188,93,87,6,149,167,61,41,21,180,72,78,128,42,57,37,121,162,126,143,160,84,1,33,124,94,196,36,182,140,34,147,23,189,81,0,85,104,31,74,20,19,144,170,95,38,139,165,46,51,50,174,118,136,123,82,67,32,91,163,25,70,65,16,190,11,113,156,71,8,184,194,191,173,18,131,110,101,59,80,100,30,134,148,195,97,58,175,151,7,102,181,68,198,142,137,158,54,52,119,49,39,107,55,14,13,111,112,89,75,154,15,135,53,183,69,159,164,9,28,155,73,99,106,4,115,152,35,161,172,86,133,76,122,116,44,125,145,56,92,108,192,40,169,129,29,90,60,177,27,43,127,96,171,141,98,114,64,79,179,47,88,5,186,199,83,153,166,24,150,10,185,62,120,197,168,17,48,63];482;False
3556;7038;10594;[78,130,176,22,26,138,178,117,2,41,3,12,77,132,193,109,66,157,103,105,45,188,93,87,6,149,167,61,146,21,180,72,187,128,42,57,37,121,162,126,143,160,84,1,33,124,94,196,36,182,140,34,147,23,189,81,0,85,104,31,74,20,19,144,170,95,38,139,165,46,51,50,174,118,136,123,82,67,32,91,163,25,70,65,16,190,11,113,156,71,8,184,194,191,173,18,131,110,101,59,80,100,30,134,148,195,97,58,175,151,7,102,181,68,198,142,137,158,54,52,119,49,39,107,55,14,13,111,112,89,75,154,15,135,53,183,69,159,164,9,28,155,73,99,106,4,115,152,35,161,172,86,133,76,122,116,44,125,145,56,92,108,192,40,169,129,29,90,60,177,27,43,127,96,171,141,98,114,64,79,179,47,88,5,186,199,83,153,166,24,150,10,185,62,120,197,168,17,48,63];483;False
1912;8218;10130;[55,46,166,174,91,5,27,150,9,105,99,73,140,178,192,10,123,17,8,94,173,18,158,129,162,197,15,135,14,49,195,194,182,65,124,147,130,22,38,139,72,1,75,151,7,153,187,127,39,107,76,122,102,114,101,110,30,134,137,86,181,82,23,12,54,142,121,168,3,98,117,2,81,52,106,118,183,83,26,79,185,148,167,61,59,36,154,93,41,133,96,157,138,45,188,87,66,126,20,146,50,53,51,29,143,156,160,71,69,190,43,128,85,164,111,159,40,37,145,189,33,13,172,67,25,109,141,35,32,56,92,88,78,171,152,57,186,113,196,89,24,198,28,74,4,97,131,0,199,62,44,34,108,6,21,155,184,161,80,58,177,169,191,11,104,180,163,170,95,31,90,125,149,120,68,63,100,116,175,176,193,16,136,144,70,19,64,103,112,84,77,115,179,60,42,47,132,165,119,48];484;False
3558;7036;10594;[90,130,176,22,26,138,178,117,2,41,3,12,77,132,193,109,66,157,103,105,45,188,93,87,6,149,167,61,146,21,180,72,187,128,42,57,37,121,162,126,143,160,84,1,33,124,94,196,36,182,140,34,147,23,189,81,0,85,104,31,74,20,19,144,170,95,38,139,165,46,51,50,174,118,136,123,82,67,32,91,163,25,70,65,16,190,11,113,156,71,8,184,194,191,173,18,131,110,101,59,80,100,30,134,148,195,97,58,175,151,7,102,181,68,198,142,137,158,54,52,119,49,39,107,55,14,13,111,112,89,75,154,15,135,53,183,69,159,164,9,28,155,73,99,106,4,115,152,35,161,172,86,133,76,122,116,44,125,145,56,92,108,192,40,169,129,29,78,60,177,27,43,127,96,171,141,98,114,64,79,179,47,88,5,186,199,83,153,166,24,150,10,185,62,120,197,168,17,48,63];485;False
1917;8216;10133;[46,55,166,174,91,5,27,150,9,105,99,73,140,178,192,10,123,17,8,94,173,18,158,129,162,197,15,135,14,49,195,194,182,65,124,147,130,22,38,139,72,1,75,151,7,153,187,127,39,107,76,122,102,114,101,110,30,134,137,86,181,82,23,12,54,142,121,168,3,98,117,2,81,52,106,118,183,83,26,79,185,148,167,61,59,36,154,93,41,133,96,157,138,45,188,87,66,126,20,146,50,53,51,29,143,156,160,71,69,190,43,128,85,164,111,159,40,37,145,189,33,13,172,67,25,109,141,35,32,56,92,88,78,171,152,57,186,113,196,89,24,198,28,74,4,97,131,0,199,62,44,34,108,6,21,155,184,161,80,58,177,169,191,11,104,180,163,170,95,31,90,125,149,120,68,63,100,116,175,176,193,16,136,144,70,19,64,103,112,84,77,115,179,60,42,47,132,165,119,48];486;False
1911;8224;10135;[55,46,25,174,91,5,27,150,9,105,99,73,140,178,192,10,123,17,8,94,173,18,158,129,162,197,15,135,14,49,195,194,182,65,124,147,130,22,38,139,72,1,75,151,7,153,187,127,39,107,76,122,102,114,101,110,30,134,137,86,181,82,23,12,54,142,121,168,3,98,117,2,81,52,106,118,183,83,26,79,185,148,167,61,59,36,154,93,41,133,96,157,138,45,188,87,66,126,20,146,50,53,51,29,143,156,160,71,69,190,43,128,85,164,111,159,40,37,145,189,33,13,172,67,166,109,141,35,32,56,92,88,78,171,152,57,186,113,196,89,24,198,28,74,4,97,131,0,199,62,44,34,108,6,21,155,184,161,80,58,177,169,191,11,104,180,163,170,95,31,90,125,149,120,68,63,100,116,175,176,193,16,136,144,70,19,64,103,112,84,77,115,179,60,42,47,132,165,119,48];487;False
3537;7050;10587;[72,130,176,22,26,138,178,117,2,41,3,12,77,132,193,109,66,157,103,105,45,188,93,87,6,149,167,61,146,21,180,90,187,128,42,57,37,121,162,126,143,160,84,1,33,124,94,196,36,182,140,34,147,23,189,81,0,85,104,31,74,20,19,144,170,95,38,139,165,46,51,50,174,118,136,123,82,67,32,91,163,25,70,65,16,190,11,113,156,71,8,184,194,191,173,18,131,110,101,59,80,100,30,134,148,195,97,58,175,151,7,102,181,68,198,142,137,158,54,52,119,49,39,107,55,14,13,111,112,89,75,154,15,135,53,183,69,159,164,9,28,155,73,99,106,4,115,152,35,161,172,86,133,76,122,116,44,125,145,56,92,108,192,40,169,129,29,78,60,177,27,43,127,96,171,141,98,114,64,79,179,47,88,5,186,199,83,153,166,24,150,10,185,62,120,197,168,17,48,63];488;False
1898;8215;10113;[180,55,166,174,91,5,27,150,9,105,99,73,140,178,192,10,123,17,8,94,173,18,158,129,162,197,15,135,14,49,195,194,182,65,124,147,130,22,38,139,72,1,75,151,7,153,187,127,39,107,76,122,102,114,101,110,30,134,137,86,181,82,23,12,54,142,121,168,3,98,117,2,81,52,106,118,183,83,26,79,185,148,167,61,59,36,154,93,41,133,96,157,138,45,188,87,66,126,20,146,50,53,51,29,143,156,160,71,69,190,43,128,85,164,111,159,40,37,145,189,33,13,172,67,25,109,141,35,32,56,92,88,78,171,152,57,186,113,196,89,24,198,28,74,4,97,131,0,199,62,44,34,108,6,21,155,184,161,80,58,177,169,191,11,104,46,163,170,95,31,90,125,149,120,68,63,100,116,175,176,193,16,136,144,70,19,64,103,112,84,77,115,179,60,42,47,132,165,119,48];489;False
3537;7039;10576;[180,130,176,22,26,138,178,117,2,41,3,12,77,132,193,109,66,157,103,105,45,188,93,87,6,149,167,61,146,21,72,90,187,128,42,57,37,121,162,126,143,160,84,1,33,124,94,196,36,182,140,34,147,23,189,81,0,85,104,31,74,20,19,144,170,95,38,139,165,46,51,50,174,118,136,123,82,67,32,91,163,25,70,65,16,190,11,113,156,71,8,184,194,191,173,18,131,110,101,59,80,100,30,134,148,195,97,58,175,151,7,102,181,68,198,142,137,158,54,52,119,49,39,107,55,14,13,111,112,89,75,154,15,135,53,183,69,159,164,9,28,155,73,99,106,4,115,152,35,161,172,86,133,76,122,116,44,125,145,56,92,108,192,40,169,129,29,78,60,177,27,43,127,96,171,141,98,114,64,79,179,47,88,5,186,199,83,153,166,24,150,10,185,62,120,197,168,17,48,63];490;False
1912;8213;10125;[92,55,166,174,91,5,27,150,9,105,99,73,140,178,192,10,123,17,8,94,173,18,158,129,162,197,15,135,14,49,195,194,182,65,124,147,130,22,38,139,72,1,75,151,7,153,187,127,39,107,76,122,102,114,101,110,30,134,137,86,181,82,23,12,54,142,121,168,3,98,117,2,81,52,106,118,183,83,26,79,185,148,167,61,59,36,154,93,41,133,96,157,138,45,188,87,66,126,20,146,50,53,51,29,143,156,160,71,69,190,43,128,85,164,111,159,40,37,145,189,33,13,172,67,25,109,141,35,32,56,180,88,78,171,152,57,186,113,196,89,24,198,28,74,4,97,131,0,199,62,44,34,108,6,21,155,184,161,80,58,177,169,191,11,104,46,163,170,95,31,90,125,149,120,68,63,100,116,175,176,193,16,136,144,70,19,64,103,112,84,77,115,179,60,42,47,132,165,119,48];491;False
3523;7057;10580;[94,130,176,22,26,138,178,117,2,41,3,12,77,132,193,109,66,157,103,105,45,188,93,87,6,149,167,61,146,21,72,90,187,128,42,57,37,121,162,126,143,160,84,1,33,124,180,196,36,182,140,34,147,23,189,81,0,85,104,31,74,20,19,144,170,95,38,139,165,46,51,50,174,118,136,123,82,67,32,91,163,25,70,65,16,190,11,113,156,71,8,184,194,191,173,18,131,110,101,59,80,100,30,134,148,195,97,58,175,151,7,102,181,68,198,142,137,158,54,52,119,49,39,107,55,14,13,111,112,89,75,154,15,135,53,183,69,159,164,9,28,155,73,99,106,4,115,152,35,161,172,86,133,76,122,116,44,125,145,56,92,108,192,40,169,129,29,78,60,177,27,43,127,96,171,141,98,114,64,79,179,47,88,5,186,199,83,153,166,24,150,10,185,62,120,197,168,17,48,63];492;False
1928;8195;10123;[92,55,166,174,91,5,27,9,150,105,99,73,140,178,192,10,123,17,8,94,173,18,158,129,162,197,15,135,14,49,195,194,182,65,124,147,130,22,38,139,72,1,75,151,7,153,187,127,39,107,76,122,102,114,101,110,30,134,137,86,181,82,23,12,54,142,121,168,3,98,117,2,81,52,106,118,183,83,26,79,185,148,167,61,59,36,154,93,41,133,96,157,138,45,188,87,66,126,20,146,50,53,51,29,143,156,160,71,69,190,43,128,85,164,111,159,40,37,145,189,33,13,172,67,25,109,141,35,32,56,180,88,78,171,152,57,186,113,196,89,24,198,28,74,4,97,131,0,199,62,44,34,108,6,21,155,184,161,80,58,177,169,191,11,104,46,163,170,95,31,90,125,149,120,68,63,100,116,175,176,193,16,136,144,70,19,64,103,112,84,77,115,179,60,42,47,132,165,119,48];493;False
3465;7060;10525;[94,130,12,22,26,138,178,117,2,41,3,176,77,132,193,109,66,157,103,105,45,188,93,87,6,149,167,61,146,21,72,90,187,128,42,57,37,121,162,126,143,160,84,1,33,124,180,196,36,182,140,34,147,23,189,81,0,85,104,31,74,20,19,144,170,95,38,139,165,46,51,50,174,118,136,123,82,67,32,91,163,25,70,65,16,190,11,113,156,71,8,184,194,191,173,18,131,110,101,59,80,100,30,134,148,195,97,58,175,151,7,102,181,68,198,142,137,158,54,52,119,49,39,107,55,14,13,111,112,89,75,154,15,135,53,183,69,159,164,9,28,155,73,99,106,4,115,152,35,161,172,86,133,76,122,116,44,125,145,56,92,108,192,40,169,129,29,78,60,177,27,43,127,96,171,141,98,114,64,79,179,47,88,5,186,199,83,153,166,24,150,10,185,62,120,197,168,17,48,63];494;False
1914;8197;10111;[180,55,166,174,91,5,27,9,150,105,99,73,140,178,192,10,123,17,8,94,173,18,158,129,162,197,15,135,14,49,195,194,182,65,124,147,130,22,38,139,72,1,75,151,7,153,187,127,39,107,76,122,102,114,101,110,30,134,137,86,181,82,23,12,54,142,121,168,3,98,117,2,81,52,106,118,183,83,26,79,185,148,167,61,59,36,154,93,41,133,96,157,138,45,188,87,66,126,20,146,50,53,51,29,143,156,160,71,69,190,43,128,85,164,111,159,40,37,145,189,33,13,172,67,25,109,141,35,32,56,92,88,78,171,152,57,186,113,196,89,24,198,28,74,4,97,131,0,199,62,44,34,108,6,21,155,184,161,80,58,177,169,191,11,104,46,163,170,95,31,90,125,149,120,68,63,100,116,175,176,193,16,136,144,70,19,64,103,112,84,77,115,179,60,42,47,132,165,119,48];495;False
3479;7042;10521;[180,130,12,22,26,138,178,117,2,41,3,176,77,132,193,109,66,157,103,105,45,188,93,87,6,149,167,61,146,21,72,90,187,128,42,57,37,121,162,126,143,160,84,1,33,124,94,196,36,182,140,34,147,23,189,81,0,85,104,31,74,20,19,144,170,95,38,139,165,46,51,50,174,118,136,123,82,67,32,91,163,25,70,65,16,190,11,113,156,71,8,184,194,191,173,18,131,110,101,59,80,100,30,134,148,195,97,58,175,151,7,102,181,68,198,142,137,158,54,52,119,49,39,107,55,14,13,111,112,89,75,154,15,135,53,183,69,159,164,9,28,155,73,99,106,4,115,152,35,161,172,86,133,76,122,116,44,125,145,56,92,108,192,40,169,129,29,78,60,177,27,43,127,96,171,141,98,114,64,79,179,47,88,5,186,199,83,153,166,24,150,10,185,62,120,197,168,17,48,63];496;True
1885;8211;10096;[180,55,166,106,91,5,27,9,150,105,99,73,140,178,192,10,123,17,8,94,173,18,158,129,162,197,15,135,14,49,195,194,182,65,124,147,130,22,38,139,72,1,75,151,7,153,187,127,39,107,76,122,102,114,101,110,30,134,137,86,181,82,23,12,54,142,121,168,3,98,117,2,81,52,174,118,183,83,26,79,185,148,167,61,59,36,154,93,41,133,96,157,138,45,188,87,66,126,20,146,50,53,51,29,143,156,160,71,69,190,43,128,85,164,111,159,40,37,145,189,33,13,172,67,25,109,141,35,32,56,92,88,78,171,152,57,186,113,196,89,24,198,28,74,4,97,131,0,199,62,44,34,108,6,21,155,184,161,80,58,177,169,191,11,104,46,163,170,95,31,90,125,149,120,68,63,100,116,175,176,193,16,136,144,70,19,64,103,112,84,77,115,179,60,42,47,132,165,119,48];497;False
3513;7037;10550;[194,130,12,22,26,138,178,117,2,41,3,176,77,132,193,109,66,157,103,105,45,188,93,87,6,149,167,61,146,21,72,90,187,128,42,57,37,121,162,126,143,160,84,1,33,124,94,196,36,182,140,34,147,23,189,81,0,85,104,31,74,20,19,144,170,95,38,139,165,46,51,50,174,118,136,123,82,67,32,91,163,25,70,65,16,190,11,113,156,71,8,184,180,191,173,18,131,110,101,59,80,100,30,134,148,195,97,58,175,151,7,102,181,68,198,142,137,158,54,52,119,49,39,107,55,14,13,111,112,89,75,154,15,135,53,183,69,159,164,9,28,155,73,99,106,4,115,152,35,161,172,86,133,76,122,116,44,125,145,56,92,108,192,40,169,129,29,78,60,177,27,43,127,96,171,141,98,114,64,79,179,47,88,5,186,199,83,153,166,24,150,10,185,62,120,197,168,17,48,63];498;True
1899;8209;10108;[92,55,166,106,91,5,27,9,150,105,99,73,140,178,192,10,123,17,8,94,173,18,158,129,162,197,15,135,14,49,195,194,182,65,124,147,130,22,38,139,72,1,75,151,7,153,187,127,39,107,76,122,102,114,101,110,30,134,137,86,181,82,23,12,54,142,121,168,3,98,117,2,81,52,174,118,183,83,26,79,185,148,167,61,59,36,154,93,41,133,96,157,138,45,188,87,66,126,20,146,50,53,51,29,143,156,160,71,69,190,43,128,85,164,111,159,40,37,145,189,33,13,172,67,25,109,141,35,32,56,180,88,78,171,152,57,186,113,196,89,24,198,28,74,4,97,131,0,199,62,44,34,108,6,21,155,184,161,80,58,177,169,191,11,104,46,163,170,95,31,90,125,149,120,68,63,100,116,175,176,193,16,136,144,70,19,64,103,112,84,77,115,179,60,42,47,132,165,119,48];499;False
3558;7027;10585;[194,12,130,22,26,138,178,117,2,41,3,176,77,132,193,109,66,157,103,105,45,188,93,87,6,149,167,61,146,21,72,90,187,128,42,57,37,121,162,126,143,160,84,1,33,124,94,196,36,182,140,34,147,23,189,81,0,85,104,31,74,20,19,144,170,95,38,139,165,46,51,50,174,118,136,123,82,67,32,91,163,25,70,65,16,190,11,113,156,71,8,184,180,191,173,18,131,110,101,59,80,100,30,134,148,195,97,58,175,151,7,102,181,68,198,142,137,158,54,52,119,49,39,107,55,14,13,111,112,89,75,154,15,135,53,183,69,159,164,9,28,155,73,99,106,4,115,152,35,161,172,86,133,76,122,116,44,125,145,56,92,108,192,40,169,129,29,78,60,177,27,43,127,96,171,141,98,114,64,79,179,47,88,5,186,199,83,153,166,24,150,10,185,62,120,197,168,17,48,63];500;False
1929;8190;10119;[92,55,56,106,91,5,27,9,150,105,99,73,140,178,192,10,123,17,8,94,173,18,158,129,162,197,15,135,14,49,195,194,182,65,124,147,130,22,38,139,72,1,75,151,7,153,187,127,39,107,76,122,102,114,101,110,30,134,137,86,181,82,23,12,54,142,121,168,3,98,117,2,81,52,174,118,183,83,26,79,185,148,167,61,59,36,154,93,41,133,96,157,138,45,188,87,66,126,20,146,50,53,51,29,143,156,160,71,69,190,43,128,85,164,111,159,40,37,145,189,33,13,172,67,25,109,141,35,32,166,180,88,78,171,152,57,186,113,196,89,24,198,28,74,4,97,131,0,199,62,44,34,108,6,21,155,184,161,80,58,177,169,191,11,104,46,163,170,95,31,90,125,149,120,68,63,100,116,175,176,193,16,136,144,70,19,64,103,112,84,77,115,179,60,42,47,132,165,119,48];501;False
3641;7026;10667;[146,12,130,22,26,138,178,117,2,41,3,176,77,132,193,109,66,157,103,105,45,188,93,87,6,149,167,61,194,21,72,90,187,128,42,57,37,121,162,126,143,160,84,1,33,124,94,196,36,182,140,34,147,23,189,81,0,85,104,31,74,20,19,144,170,95,38,139,165,46,51,50,174,118,136,123,82,67,32,91,163,25,70,65,16,190,11,113,156,71,8,184,180,191,173,18,131,110,101,59,80,100,30,134,148,195,97,58,175,151,7,102,181,68,198,142,137,158,54,52,119,49,39,107,55,14,13,111,112,89,75,154,15,135,53,183,69,159,164,9,28,155,73,99,106,4,115,152,35,161,172,86,133,76,122,116,44,125,145,56,92,108,192,40,169,129,29,78,60,177,27,43,127,96,171,141,98,114,64,79,179,47,88,5,186,199,83,153,166,24,150,10,185,62,120,197,168,17,48,63];502;False
1876;8224;10100;[56,55,92,106,91,5,27,9,150,105,99,73,140,178,192,10,123,17,8,94,173,18,158,129,162,197,15,135,14,49,195,194,182,65,124,147,130,22,38,139,72,1,75,151,7,153,187,127,39,107,76,122,102,114,101,110,30,134,137,86,181,82,23,12,54,142,121,168,3,98,117,2,81,52,174,118,183,83,26,79,185,148,167,61,59,36,154,93,41,133,96,157,138,45,188,87,66,126,20,146,50,53,51,29,143,156,160,71,69,190,43,128,85,164,111,159,40,37,145,189,33,13,172,67,25,109,141,35,32,166,180,88,78,171,152,57,186,113,196,89,24,198,28,74,4,97,131,0,199,62,44,34,108,6,21,155,184,161,80,58,177,169,191,11,104,46,163,170,95,31,90,125,149,120,68,63,100,116,175,176,193,16,136,144,70,19,64,103,112,84,77,115,179,60,42,47,132,165,119,48];503;False
3637;7026;10663;[21,12,130,22,26,138,178,117,2,41,3,176,77,132,193,109,66,157,103,105,45,188,93,87,6,149,167,61,194,146,72,90,187,128,42,57,37,121,162,126,143,160,84,1,33,124,94,196,36,182,140,34,147,23,189,81,0,85,104,31,74,20,19,144,170,95,38,139,165,46,51,50,174,118,136,123,82,67,32,91,163,25,70,65,16,190,11,113,156,71,8,184,180,191,173,18,131,110,101,59,80,100,30,134,148,195,97,58,175,151,7,102,181,68,198,142,137,158,54,52,119,49,39,107,55,14,13,111,112,89,75,154,15,135,53,183,69,159,164,9,28,155,73,99,106,4,115,152,35,161,172,86,133,76,122,116,44,125,145,56,92,108,192,40,169,129,29,78,60,177,27,43,127,96,171,141,98,114,64,79,179,47,88,5,186,199,83,153,166,24,150,10,185,62,120,197,168,17,48,63];504;False
1883;8218;10101;[55,56,92,106,91,5,27,9,150,105,99,73,140,178,192,10,123,17,8,94,173,18,158,129,162,197,15,135,14,49,195,194,182,65,124,147,130,22,38,139,72,1,75,151,7,153,187,127,39,107,76,122,102,114,101,110,30,134,137,86,181,82,23,12,54,142,121,168,3,98,117,2,81,52,174,118,183,83,26,79,185,148,167,61,59,36,154,93,41,133,96,157,138,45,188,87,66,126,20,146,50,53,51,29,143,156,160,71,69,190,43,128,85,164,111,159,40,37,145,189,33,13,172,67,25,109,141,35,32,166,180,88,78,171,152,57,186,113,196,89,24,198,28,74,4,97,131,0,199,62,44,34,108,6,21,155,184,161,80,58,177,169,191,11,104,46,163,170,95,31,90,125,149,120,68,63,100,116,175,176,193,16,136,144,70,19,64,103,112,84,77,115,179,60,42,47,132,165,119,48];505;False
1867;8252;10119;[192,55,92,106,91,5,27,9,150,105,99,73,140,178,56,10,123,17,8,94,173,18,158,129,162,197,15,135,14,49,195,194,182,65,124,147,130,22,38,139,72,1,75,151,7,153,187,127,39,107,76,122,102,114,101,110,30,134,137,86,181,82,23,12,54,142,121,168,3,98,117,2,81,52,174,118,183,83,26,79,185,148,167,61,59,36,154,93,41,133,96,157,138,45,188,87,66,126,20,146,50,53,51,29,143,156,160,71,69,190,43,128,85,164,111,159,40,37,145,189,33,13,172,67,25,109,141,35,32,166,180,88,78,171,152,57,186,113,196,89,24,198,28,74,4,97,131,0,199,62,44,34,108,6,21,155,184,161,80,58,177,169,191,11,104,46,163,170,95,31,90,125,149,120,68,63,100,116,175,176,193,16,136,144,70,19,64,103,112,84,77,115,179,60,42,47,132,165,119,48];506;False
3598;7023;10621;[194,12,130,22,26,138,178,117,2,41,3,176,77,132,193,109,66,157,103,105,45,188,93,87,6,149,167,61,21,146,72,90,187,128,42,57,37,121,162,126,143,160,84,1,33,124,94,196,36,182,140,34,147,23,189,81,0,85,104,31,74,20,19,144,170,95,38,139,165,46,51,50,174,118,136,123,82,67,32,91,163,25,70,65,16,190,11,113,156,71,8,184,180,191,173,18,131,110,101,59,80,100,30,134,148,195,97,58,175,151,7,102,181,68,198,142,137,158,54,52,119,49,39,107,55,14,13,111,112,89,75,154,15,135,53,183,69,159,164,9,28,155,73,99,106,4,115,152,35,161,172,86,133,76,122,116,44,125,145,56,92,108,192,40,169,129,29,78,60,177,27,43,127,96,171,141,98,114,64,79,179,47,88,5,186,199,83,153,166,24,150,10,185,62,120,197,168,17,48,63];507;False
1867;8248;10115;[117,56,92,106,91,5,27,9,150,105,99,73,140,178,192,10,123,17,8,94,173,18,158,129,162,197,15,135,14,49,195,194,182,65,124,147,130,22,38,139,72,1,75,151,7,153,187,127,39,107,76,122,102,114,101,110,30,134,137,86,181,82,23,12,54,142,121,168,3,98,55,2,81,52,174,118,183,83,26,79,185,148,167,61,59,36,154,93,41,133,96,157,138,45,188,87,66,126,20,146,50,53,51,29,143,156,160,71,69,190,43,128,85,164,111,159,40,37,145,189,33,13,172,67,25,109,141,35,32,166,180,88,78,171,152,57,186,113,196,89,24,198,28,74,4,97,131,0,199,62,44,34,108,6,21,155,184,161,80,58,177,169,191,11,104,46,163,170,95,31,90,125,149,120,68,63,100,116,175,176,193,16,136,144,70,19,64,103,112,84,77,115,179,60,42,47,132,165,119,48];508;False
3549;7024;10573;[20,12,130,22,26,138,178,117,2,41,3,176,77,132,193,109,66,157,103,105,45,188,93,87,6,149,167,61,21,146,72,90,187,128,42,57,37,121,162,126,143,160,84,1,33,124,94,196,36,182,140,34,147,23,189,81,0,85,104,31,74,194,19,144,170,95,38,139,165,46,51,50,174,118,136,123,82,67,32,91,163,25,70,65,16,190,11,113,156,71,8,184,180,191,173,18,131,110,101,59,80,100,30,134,148,195,97,58,175,151,7,102,181,68,198,142,137,158,54,52,119,49,39,107,55,14,13,111,112,89,75,154,15,135,53,183,69,159,164,9,28,155,73,99,106,4,115,152,35,161,172,86,133,76,122,116,44,125,145,56,92,108,192,40,169,129,29,78,60,177,27,43,127,96,171,141,98,114,64,79,179,47,88,5,186,199,83,153,166,24,150,10,185,62,120,197,168,17,48,63];509;True
1885;8193;10078;[194,56,92,106,91,5,27,9,150,105,99,73,140,178,192,10,123,17,8,94,173,18,158,129,162,197,15,135,14,49,195,117,182,65,124,147,130,22,38,139,72,1,75,151,7,153,187,127,39,107,76,122,102,114,101,110,30,134,137,86,181,82,23,12,54,142,121,168,3,98,55,2,81,52,174,118,183,83,26,79,185,148,167,61,59,36,154,93,41,133,96,157,138,45,188,87,66,126,20,146,50,53,51,29,143,156,160,71,69,190,43,128,85,164,111,159,40,37,145,189,33,13,172,67,25,109,141,35,32,166,180,88,78,171,152,57,186,113,196,89,24,198,28,74,4,97,131,0,199,62,44,34,108,6,21,155,184,161,80,58,177,169,191,11,104,46,163,170,95,31,90,125,149,120,68,63,100,116,175,176,193,16,136,144,70,19,64,103,112,84,77,115,179,60,42,47,132,165,119,48];510;False
3663;7017;10680;[136,12,130,22,26,138,178,117,2,41,3,176,77,132,193,109,66,157,103,105,45,188,93,87,6,149,167,61,21,146,72,90,187,128,42,57,37,121,162,126,143,160,84,1,33,124,94,196,36,182,140,34,147,23,189,81,0,85,104,31,74,194,19,144,170,95,38,139,165,46,51,50,174,118,20,123,82,67,32,91,163,25,70,65,16,190,11,113,156,71,8,184,180,191,173,18,131,110,101,59,80,100,30,134,148,195,97,58,175,151,7,102,181,68,198,142,137,158,54,52,119,49,39,107,55,14,13,111,112,89,75,154,15,135,53,183,69,159,164,9,28,155,73,99,106,4,115,152,35,161,172,86,133,76,122,116,44,125,145,56,92,108,192,40,169,129,29,78,60,177,27,43,127,96,171,141,98,114,64,79,179,47,88,5,186,199,83,153,166,24,150,10,185,62,120,197,168,17,48,63];511;False
1980;8150;10130;[194,56,92,160,91,5,27,9,150,105,99,73,140,178,192,10,123,17,8,94,173,18,158,129,162,197,15,135,14,49,195,117,182,65,124,147,130,22,38,139,72,1,75,151,7,153,187,127,39,107,76,122,102,114,101,110,30,134,137,86,181,82,23,12,54,142,121,168,3,98,55,2,81,52,174,118,183,83,26,79,185,148,167,61,59,36,154,93,41,133,96,157,138,45,188,87,66,126,20,146,50,53,51,29,143,156,106,71,69,190,43,128,85,164,111,159,40,37,145,189,33,13,172,67,25,109,141,35,32,166,180,88,78,171,152,57,186,113,196,89,24,198,28,74,4,97,131,0,199,62,44,34,108,6,21,155,184,161,80,58,177,169,191,11,104,46,163,170,95,31,90,125,149,120,68,63,100,116,175,176,193,16,136,144,70,19,64,103,112,84,77,115,179,60,42,47,132,165,119,48];512;False
3644;7009;10653;[84,12,130,22,26,138,178,117,2,41,3,176,77,132,193,109,66,157,103,105,45,188,93,87,6,149,167,61,21,146,72,90,187,128,42,57,37,121,162,126,143,160,136,1,33,124,94,196,36,182,140,34,147,23,189,81,0,85,104,31,74,194,19,144,170,95,38,139,165,46,51,50,174,118,20,123,82,67,32,91,163,25,70,65,16,190,11,113,156,71,8,184,180,191,173,18,131,110,101,59,80,100,30,134,148,195,97,58,175,151,7,102,181,68,198,142,137,158,54,52,119,49,39,107,55,14,13,111,112,89,75,154,15,135,53,183,69,159,164,9,28,155,73,99,106,4,115,152,35,161,172,86,133,76,122,116,44,125,145,56,92,108,192,40,169,129,29,78,60,177,27,43,127,96,171,141,98,114,64,79,179,47,88,5,186,199,83,153,166,24,150,10,185,62,120,197,168,17,48,63];513;True
1955;8161;10116;[194,56,92,9,91,5,27,160,150,105,99,73,140,178,192,10,123,17,8,94,173,18,158,129,162,197,15,135,14,49,195,117,182,65,124,147,130,22,38,139,72,1,75,151,7,153,187,127,39,107,76,122,102,114,101,110,30,134,137,86,181,82,23,12,54,142,121,168,3,98,55,2,81,52,174,118,183,83,26,79,185,148,167,61,59,36,154,93,41,133,96,157,138,45,188,87,66,126,20,146,50,53,51,29,143,156,106,71,69,190,43,128,85,164,111,159,40,37,145,189,33,13,172,67,25,109,141,35,32,166,180,88,78,171,152,57,186,113,196,89,24,198,28,74,4,97,131,0,199,62,44,34,108,6,21,155,184,161,80,58,177,169,191,11,104,46,163,170,95,31,90,125,149,120,68,63,100,116,175,176,193,16,136,144,70,19,64,103,112,84,77,115,179,60,42,47,132,165,119,48];514;False
3582;7015;10597;[180,12,130,22,26,138,178,117,2,41,3,176,77,132,193,109,66,157,103,105,45,188,93,87,6,149,167,61,21,146,72,90,187,128,42,57,37,121,162,126,143,160,136,1,33,124,94,196,36,182,140,34,147,23,189,81,0,85,104,31,74,194,19,144,170,95,38,139,165,46,51,50,174,118,20,123,82,67,32,91,163,25,70,65,16,190,11,113,156,71,8,184,84,191,173,18,131,110,101,59,80,100,30,134,148,195,97,58,175,151,7,102,181,68,198,142,137,158,54,52,119,49,39,107,55,14,13,111,112,89,75,154,15,135,53,183,69,159,164,9,28,155,73,99,106,4,115,152,35,161,172,86,133,76,122,116,44,125,145,56,92,108,192,40,169,129,29,78,60,177,27,43,127,96,171,141,98,114,64,79,179,47,88,5,186,199,83,153,166,24,150,10,185,62,120,197,168,17,48,63];515;True
1971;8149;10120;[194,56,28,9,91,5,27,160,150,105,99,73,140,178,192,10,123,17,8,94,173,18,158,129,162,197,15,135,14,49,195,117,182,65,124,147,130,22,38,139,72,1,75,151,7,153,187,127,39,107,76,122,102,114,101,110,30,134,137,86,181,82,23,12,54,142,121,168,3,98,55,2,81,52,174,118,183,83,26,79,185,148,167,61,59,36,154,93,41,133,96,157,138,45,188,87,66,126,20,146,50,53,51,29,143,156,106,71,69,190,43,128,85,164,111,159,40,37,145,189,33,13,172,67,25,109,141,35,32,166,180,88,78,171,152,57,186,113,196,89,24,198,92,74,4,97,131,0,199,62,44,34,108,6,21,155,184,161,80,58,177,169,191,11,104,46,163,170,95,31,90,125,149,120,68,63,100,116,175,176,193,16,136,144,70,19,64,103,112,84,77,115,179,60,42,47,132,165,119,48];516;False
3545;7029;10574;[146,12,130,22,26,138,178,117,2,41,3,176,77,132,193,109,66,157,103,105,45,188,93,87,6,149,167,61,21,180,72,90,187,128,42,57,37,121,162,126,143,160,136,1,33,124,94,196,36,182,140,34,147,23,189,81,0,85,104,31,74,194,19,144,170,95,38,139,165,46,51,50,174,118,20,123,82,67,32,91,163,25,70,65,16,190,11,113,156,71,8,184,84,191,173,18,131,110,101,59,80,100,30,134,148,195,97,58,175,151,7,102,181,68,198,142,137,158,54,52,119,49,39,107,55,14,13,111,112,89,75,154,15,135,53,183,69,159,164,9,28,155,73,99,106,4,115,152,35,161,172,86,133,76,122,116,44,125,145,56,92,108,192,40,169,129,29,78,60,177,27,43,127,96,171,141,98,114,64,79,179,47,88,5,186,199,83,153,166,24,150,10,185,62,120,197,168,17,48,63];517;True
1941;8163;10104;[194,56,28,9,166,5,27,160,150,105,99,73,140,178,192,10,123,17,8,94,173,18,158,129,162,197,15,135,14,49,195,117,182,65,124,147,130,22,38,139,72,1,75,151,7,153,187,127,39,107,76,122,102,114,101,110,30,134,137,86,181,82,23,12,54,142,121,168,3,98,55,2,81,52,174,118,183,83,26,79,185,148,167,61,59,36,154,93,41,133,96,157,138,45,188,87,66,126,20,146,50,53,51,29,143,156,106,71,69,190,43,128,85,164,111,159,40,37,145,189,33,13,172,67,25,109,141,35,32,91,180,88,78,171,152,57,186,113,196,89,24,198,92,74,4,97,131,0,199,62,44,34,108,6,21,155,184,161,80,58,177,169,191,11,104,46,163,170,95,31,90,125,149,120,68,63,100,116,175,176,193,16,136,144,70,19,64,103,112,84,77,115,179,60,42,47,132,165,119,48];518;False
3544;7034;10578;[19,12,130,22,26,138,178,117,2,41,3,176,77,132,193,109,66,157,103,105,45,188,93,87,6,149,167,61,21,180,72,90,187,128,42,57,37,121,162,126,143,160,136,1,33,124,94,196,36,182,140,34,147,23,189,81,0,85,104,31,74,194,146,144,170,95,38,139,165,46,51,50,174,118,20,123,82,67,32,91,163,25,70,65,16,190,11,113,156,71,8,184,84,191,173,18,131,110,101,59,80,100,30,134,148,195,97,58,175,151,7,102,181,68,198,142,137,158,54,52,119,49,39,107,55,14,13,111,112,89,75,154,15,135,53,183,69,159,164,9,28,155,73,99,106,4,115,152,35,161,172,86,133,76,122,116,44,125,145,56,92,108,192,40,169,129,29,78,60,177,27,43,127,96,171,141,98,114,64,79,179,47,88,5,186,199,83,153,166,24,150,10,185,62,120,197,168,17,48,63];519;False
1925;8175;10100;[194,56,92,9,166,5,27,160,150,105,99,73,140,178,192,10,123,17,8,94,173,18,158,129,162,197,15,135,14,49,195,117,182,65,124,147,130,22,38,139,72,1,75,151,7,153,187,127,39,107,76,122,102,114,101,110,30,134,137,86,181,82,23,12,54,142,121,168,3,98,55,2,81,52,174,118,183,83,26,79,185,148,167,61,59,36,154,93,41,133,96,157,138,45,188,87,66,126,20,146,50,53,51,29,143,156,106,71,69,190,43,128,85,164,111,159,40,37,145,189,33,13,172,67,25,109,141,35,32,91,180,88,78,171,152,57,186,113,196,89,24,198,28,74,4,97,131,0,199,62,44,34,108,6,21,155,184,161,80,58,177,169,191,11,104,46,163,170,95,31,90,125,149,120,68,63,100,116,175,176,193,16,136,144,70,19,64,103,112,84,77,115,179,60,42,47,132,165,119,48];520;False
3462;7054;10516;[20,12,130,22,26,138,178,117,2,41,3,176,77,132,193,109,66,157,103,105,45,188,93,87,6,149,167,61,21,180,72,90,187,128,42,57,37,121,162,126,143,160,136,1,33,124,94,196,36,182,140,34,147,23,189,81,0,85,104,31,74,194,146,144,170,95,38,139,165,46,51,50,174,118,19,123,82,67,32,91,163,25,70,65,16,190,11,113,156,71,8,184,84,191,173,18,131,110,101,59,80,100,30,134,148,195,97,58,175,151,7,102,181,68,198,142,137,158,54,52,119,49,39,107,55,14,13,111,112,89,75,154,15,135,53,183,69,159,164,9,28,155,73,99,106,4,115,152,35,161,172,86,133,76,122,116,44,125,145,56,92,108,192,40,169,129,29,78,60,177,27,43,127,96,171,141,98,114,64,79,179,47,88,5,186,199,83,153,166,24,150,10,185,62,120,197,168,17,48,63];521;False
1924;8185;10109;[194,56,92,124,166,5,27,160,150,105,99,73,140,178,192,10,123,17,8,94,173,18,158,129,162,197,15,135,14,49,195,117,182,65,9,147,130,22,38,139,72,1,75,151,7,153,187,127,39,107,76,122,102,114,101,110,30,134,137,86,181,82,23,12,54,142,121,168,3,98,55,2,81,52,174,118,183,83,26,79,185,148,167,61,59,36,154,93,41,133,96,157,138,45,188,87,66,126,20,146,50,53,51,29,143,156,106,71,69,190,43,128,85,164,111,159,40,37,145,189,33,13,172,67,25,109,141,35,32,91,180,88,78,171,152,57,186,113,196,89,24,198,28,74,4,97,131,0,199,62,44,34,108,6,21,155,184,161,80,58,177,169,191,11,104,46,163,170,95,31,90,125,149,120,68,63,100,116,175,176,193,16,136,144,70,19,64,103,112,84,77,115,179,60,42,47,132,165,119,48];522;False
3469;7047;10516;[84,12,130,22,26,138,178,117,2,41,3,176,77,132,193,109,66,157,103,105,45,188,93,87,6,149,167,61,21,180,72,90,187,128,42,57,37,121,162,126,143,160,136,1,33,124,94,196,36,182,140,34,147,23,189,81,0,85,104,31,74,194,146,144,170,95,38,139,165,46,51,50,174,118,19,123,82,67,32,91,163,25,70,65,16,190,11,113,156,71,8,184,20,191,173,18,131,110,101,59,80,100,30,134,148,195,97,58,175,151,7,102,181,68,198,142,137,158,54,52,119,49,39,107,55,14,13,111,112,89,75,154,15,135,53,183,69,159,164,9,28,155,73,99,106,4,115,152,35,161,172,86,133,76,122,116,44,125,145,56,92,108,192,40,169,129,29,78,60,177,27,43,127,96,171,141,98,114,64,79,179,47,88,5,186,199,83,153,166,24,150,10,185,62,120,197,168,17,48,63];523;False
1904;8177;10081;[194,56,92,41,166,5,27,160,150,105,99,73,140,178,192,10,123,17,8,94,173,18,158,129,162,197,15,135,14,49,195,117,182,65,9,147,130,22,38,139,72,1,75,151,7,153,187,127,39,107,76,122,102,114,101,110,30,134,137,86,181,82,23,12,54,142,121,168,3,98,55,2,81,52,174,118,183,83,26,79,185,148,167,61,59,36,154,93,124,133,96,157,138,45,188,87,66,126,20,146,50,53,51,29,143,156,106,71,69,190,43,128,85,164,111,159,40,37,145,189,33,13,172,67,25,109,141,35,32,91,180,88,78,171,152,57,186,113,196,89,24,198,28,74,4,97,131,0,199,62,44,34,108,6,21,155,184,161,80,58,177,169,191,11,104,46,163,170,95,31,90,125,149,120,68,63,100,116,175,176,193,16,136,144,70,19,64,103,112,84,77,115,179,60,42,47,132,165,119,48];524;False
3411;7053;10464;[154,12,130,22,26,138,178,117,2,41,3,176,77,132,193,109,66,157,103,105,45,188,93,87,6,149,167,61,21,180,72,90,187,128,42,57,37,121,162,126,143,160,136,1,33,124,94,196,36,182,140,34,147,23,189,81,0,85,104,31,74,194,146,144,170,95,38,139,165,46,51,50,174,118,19,123,82,67,32,91,163,25,70,65,16,190,11,113,156,71,8,184,20,191,173,18,131,110,101,59,80,100,30,134,148,195,97,58,175,151,7,102,181,68,198,142,137,158,54,52,119,49,39,107,55,14,13,111,112,89,75,84,15,135,53,183,69,159,164,9,28,155,73,99,106,4,115,152,35,161,172,86,133,76,122,116,44,125,145,56,92,108,192,40,169,129,29,78,60,177,27,43,127,96,171,141,98,114,64,79,179,47,88,5,186,199,83,153,166,24,150,10,185,62,120,197,168,17,48,63];525;False
1873;8178;10051;[194,56,92,41,166,5,27,150,160,105,99,73,140,178,192,10,123,17,8,94,173,18,158,129,162,197,15,135,14,49,195,117,182,65,9,147,130,22,38,139,72,1,75,151,7,153,187,127,39,107,76,122,102,114,101,110,30,134,137,86,181,82,23,12,54,142,121,168,3,98,55,2,81,52,174,118,183,83,26,79,185,148,167,61,59,36,154,93,124,133,96,157,138,45,188,87,66,126,20,146,50,53,51,29,143,156,106,71,69,190,43,128,85,164,111,159,40,37,145,189,33,13,172,67,25,109,141,35,32,91,180,88,78,171,152,57,186,113,196,89,24,198,28,74,4,97,131,0,199,62,44,34,108,6,21,155,184,161,80,58,177,169,191,11,104,46,163,170,95,31,90,125,149,120,68,63,100,116,175,176,193,16,136,144,70,19,64,103,112,84,77,115,179,60,42,47,132,165,119,48];526;False
3345;7062;10407;[90,12,130,22,26,138,178,117,2,41,3,176,77,132,193,109,66,157,103,105,45,188,93,87,6,149,167,61,21,180,72,154,187,128,42,57,37,121,162,126,143,160,136,1,33,124,94,196,36,182,140,34,147,23,189,81,0,85,104,31,74,194,146,144,170,95,38,139,165,46,51,50,174,118,19,123,82,67,32,91,163,25,70,65,16,190,11,113,156,71,8,184,20,191,173,18,131,110,101,59,80,100,30,134,148,195,97,58,175,151,7,102,181,68,198,142,137,158,54,52,119,49,39,107,55,14,13,111,112,89,75,84,15,135,53,183,69,159,164,9,28,155,73,99,106,4,115,152,35,161,172,86,133,76,122,116,44,125,145,56,92,108,192,40,169,129,29,78,60,177,27,43,127,96,171,141,98,114,64,79,179,47,88,5,186,199,83,153,166,24,150,10,185,62,120,197,168,17,48,63];527;False
1855;8233;10088;[117,56,92,41,166,5,27,150,160,105,99,73,140,178,192,10,123,17,8,94,173,18,158,129,162,197,15,135,14,49,195,194,182,65,9,147,130,22,38,139,72,1,75,151,7,153,187,127,39,107,76,122,102,114,101,110,30,134,137,86,181,82,23,12,54,142,121,168,3,98,55,2,81,52,174,118,183,83,26,79,185,148,167,61,59,36,154,93,124,133,96,157,138,45,188,87,66,126,20,146,50,53,51,29,143,156,106,71,69,190,43,128,85,164,111,159,40,37,145,189,33,13,172,67,25,109,141,35,32,91,180,88,78,171,152,57,186,113,196,89,24,198,28,74,4,97,131,0,199,62,44,34,108,6,21,155,184,161,80,58,177,169,191,11,104,46,163,170,95,31,90,125,149,120,68,63,100,116,175,176,193,16,136,144,70,19,64,103,112,84,77,115,179,60,42,47,132,165,119,48];528;False
3239;7064;10303;[82,12,130,22,26,138,178,117,2,41,3,176,77,132,193,109,66,157,103,105,45,188,93,87,6,149,167,61,21,180,72,154,187,128,42,57,37,121,162,126,143,160,136,1,33,124,94,196,36,182,140,34,147,23,189,81,0,85,104,31,74,194,146,144,170,95,38,139,165,46,51,50,174,118,19,123,90,67,32,91,163,25,70,65,16,190,11,113,156,71,8,184,20,191,173,18,131,110,101,59,80,100,30,134,148,195,97,58,175,151,7,102,181,68,198,142,137,158,54,52,119,49,39,107,55,14,13,111,112,89,75,84,15,135,53,183,69,159,164,9,28,155,73,99,106,4,115,152,35,161,172,86,133,76,122,116,44,125,145,56,92,108,192,40,169,129,29,78,60,177,27,43,127,96,171,141,98,114,64,79,179,47,88,5,186,199,83,153,166,24,150,10,185,62,120,197,168,17,48,63];529;True
1871;8203;10074;[55,56,92,41,166,5,27,150,160,105,99,73,140,178,192,10,123,17,8,94,173,18,158,129,162,197,15,135,14,49,195,194,182,65,9,147,130,22,38,139,72,1,75,151,7,153,187,127,39,107,76,122,102,114,101,110,30,134,137,86,181,82,23,12,54,142,121,168,3,98,117,2,81,52,174,118,183,83,26,79,185,148,167,61,59,36,154,93,124,133,96,157,138,45,188,87,66,126,20,146,50,53,51,29,143,156,106,71,69,190,43,128,85,164,111,159,40,37,145,189,33,13,172,67,25,109,141,35,32,91,180,88,78,171,152,57,186,113,196,89,24,198,28,74,4,97,131,0,199,62,44,34,108,6,21,155,184,161,80,58,177,169,191,11,104,46,163,170,95,31,90,125,149,120,68,63,100,116,175,176,193,16,136,144,70,19,64,103,112,84,77,115,179,60,42,47,132,165,119,48];530;False
3288;7059;10347;[82,77,130,22,26,138,178,117,2,41,3,176,12,132,193,109,66,157,103,105,45,188,93,87,6,149,167,61,21,180,72,154,187,128,42,57,37,121,162,126,143,160,136,1,33,124,94,196,36,182,140,34,147,23,189,81,0,85,104,31,74,194,146,144,170,95,38,139,165,46,51,50,174,118,19,123,90,67,32,91,163,25,70,65,16,190,11,113,156,71,8,184,20,191,173,18,131,110,101,59,80,100,30,134,148,195,97,58,175,151,7,102,181,68,198,142,137,158,54,52,119,49,39,107,55,14,13,111,112,89,75,84,15,135,53,183,69,159,164,9,28,155,73,99,106,4,115,152,35,161,172,86,133,76,122,116,44,125,145,56,92,108,192,40,169,129,29,78,60,177,27,43,127,96,171,141,98,114,64,79,179,47,88,5,186,199,83,153,166,24,150,10,185,62,120,197,168,17,48,63];531;True
1864;8209;10073;[56,55,92,41,166,5,27,150,160,105,99,73,140,178,192,10,123,17,8,94,173,18,158,129,162,197,15,135,14,49,195,194,182,65,9,147,130,22,38,139,72,1,75,151,7,153,187,127,39,107,76,122,102,114,101,110,30,134,137,86,181,82,23,12,54,142,121,168,3,98,117,2,81,52,174,118,183,83,26,79,185,148,167,61,59,36,154,93,124,133,96,157,138,45,188,87,66,126,20,146,50,53,51,29,143,156,106,71,69,190,43,128,85,164,111,159,40,37,145,189,33,13,172,67,25,109,141,35,32,91,180,88,78,171,152,57,186,113,196,89,24,198,28,74,4,97,131,0,199,62,44,34,108,6,21,155,184,161,80,58,177,169,191,11,104,46,163,170,95,31,90,125,149,120,68,63,100,116,175,176,193,16,136,144,70,19,64,103,112,84,77,115,179,60,42,47,132,165,119,48];532;False
1844;8200;10044;[156,56,92,41,166,5,27,150,160,105,99,73,140,178,192,10,123,17,8,94,173,18,158,129,162,197,15,135,14,49,195,194,182,65,9,147,130,22,38,139,72,1,75,151,7,153,187,127,39,107,76,122,102,114,101,110,30,134,137,86,181,82,23,12,54,142,121,168,3,98,117,2,81,52,174,118,183,83,26,79,185,148,167,61,59,36,154,93,124,133,96,157,138,45,188,87,66,126,20,146,50,53,51,29,143,55,106,71,69,190,43,128,85,164,111,159,40,37,145,189,33,13,172,67,25,109,141,35,32,91,180,88,78,171,152,57,186,113,196,89,24,198,28,74,4,97,131,0,199,62,44,34,108,6,21,155,184,161,80,58,177,169,191,11,104,46,163,170,95,31,90,125,149,120,68,63,100,116,175,176,193,16,136,144,70,19,64,103,112,84,77,115,179,60,42,47,132,165,119,48];533;False
3395;7051;10446;[82,187,130,22,26,138,178,117,2,41,3,176,12,132,193,109,66,157,103,105,45,188,93,87,6,149,167,61,21,180,72,154,77,128,42,57,37,121,162,126,143,160,136,1,33,124,94,196,36,182,140,34,147,23,189,81,0,85,104,31,74,194,146,144,170,95,38,139,165,46,51,50,174,118,19,123,90,67,32,91,163,25,70,65,16,190,11,113,156,71,8,184,20,191,173,18,131,110,101,59,80,100,30,134,148,195,97,58,175,151,7,102,181,68,198,142,137,158,54,52,119,49,39,107,55,14,13,111,112,89,75,84,15,135,53,183,69,159,164,9,28,155,73,99,106,4,115,152,35,161,172,86,133,76,122,116,44,125,145,56,92,108,192,40,169,129,29,78,60,177,27,43,127,96,171,141,98,114,64,79,179,47,88,5,186,199,83,153,166,24,150,10,185,62,120,197,168,17,48,63];534;False
1836;8248;10084;[93,56,92,41,166,5,27,150,160,105,99,73,140,178,192,10,123,17,8,94,173,18,158,129,162,197,15,135,14,49,195,194,182,65,9,147,130,22,38,139,72,1,75,151,7,153,187,127,39,107,76,122,102,114,101,110,30,134,137,86,181,82,23,12,54,142,121,168,3,98,117,2,81,52,174,118,183,83,26,79,185,148,167,61,59,36,154,156,124,133,96,157,138,45,188,87,66,126,20,146,50,53,51,29,143,55,106,71,69,190,43,128,85,164,111,159,40,37,145,189,33,13,172,67,25,109,141,35,32,91,180,88,78,171,152,57,186,113,196,89,24,198,28,74,4,97,131,0,199,62,44,34,108,6,21,155,184,161,80,58,177,169,191,11,104,46,163,170,95,31,90,125,149,120,68,63,100,116,175,176,193,16,136,144,70,19,64,103,112,84,77,115,179,60,42,47,132,165,119,48];535;False
3355;7057;10412;[82,172,130,22,26,138,178,117,2,41,3,176,12,132,193,109,66,157,103,105,45,188,93,87,6,149,167,61,21,180,72,154,77,128,42,57,37,121,162,126,143,160,136,1,33,124,94,196,36,182,140,34,147,23,189,81,0,85,104,31,74,194,146,144,170,95,38,139,165,46,51,50,174,118,19,123,90,67,32,91,163,25,70,65,16,190,11,113,156,71,8,184,20,191,173,18,131,110,101,59,80,100,30,134,148,195,97,58,175,151,7,102,181,68,198,142,137,158,54,52,119,49,39,107,55,14,13,111,112,89,75,84,15,135,53,183,69,159,164,9,28,155,73,99,106,4,115,152,35,161,187,86,133,76,122,116,44,125,145,56,92,108,192,40,169,129,29,78,60,177,27,43,127,96,171,141,98,114,64,79,179,47,88,5,186,199,83,153,166,24,150,10,185,62,120,197,168,17,48,63];536;False
1814;8248;10062;[160,56,92,41,166,5,27,150,93,105,99,73,140,178,192,10,123,17,8,94,173,18,158,129,162,197,15,135,14,49,195,194,182,65,9,147,130,22,38,139,72,1,75,151,7,153,187,127,39,107,76,122,102,114,101,110,30,134,137,86,181,82,23,12,54,142,121,168,3,98,117,2,81,52,174,118,183,83,26,79,185,148,167,61,59,36,154,156,124,133,96,157,138,45,188,87,66,126,20,146,50,53,51,29,143,55,106,71,69,190,43,128,85,164,111,159,40,37,145,189,33,13,172,67,25,109,141,35,32,91,180,88,78,171,152,57,186,113,196,89,24,198,28,74,4,97,131,0,199,62,44,34,108,6,21,155,184,161,80,58,177,169,191,11,104,46,163,170,95,31,90,125,149,120,68,63,100,116,175,176,193,16,136,144,70,19,64,103,112,84,77,115,179,60,42,47,132,165,119,48];537;True
3379;7054;10433;[82,172,130,22,37,138,178,117,2,41,3,176,12,132,193,109,66,157,103,105,45,188,93,87,6,149,167,61,21,180,72,154,77,128,42,57,26,121,162,126,143,160,136,1,33,124,94,196,36,182,140,34,147,23,189,81,0,85,104,31,74,194,146,144,170,95,38,139,165,46,51,50,174,118,19,123,90,67,32,91,163,25,70,65,16,190,11,113,156,71,8,184,20,191,173,18,131,110,101,59,80,100,30,134,148,195,97,58,175,151,7,102,181,68,198,142,137,158,54,52,119,49,39,107,55,14,13,111,112,89,75,84,15,135,53,183,69,159,164,9,28,155,73,99,106,4,115,152,35,161,187,86,133,76,122,116,44,125,145,56,92,108,192,40,169,129,29,78,60,177,27,43,127,96,171,141,98,114,64,79,179,47,88,5,186,199,83,153,166,24,150,10,185,62,120,197,168,17,48,63];538;False
1805;8252;10057;[117,56,92,41,166,5,27,150,93,105,99,73,140,178,192,10,123,17,8,94,173,18,158,129,162,197,15,135,14,49,195,194,182,65,9,147,130,22,38,139,72,1,75,151,7,153,187,127,39,107,76,122,102,114,101,110,30,134,137,86,181,82,23,12,54,142,121,168,3,98,160,2,81,52,174,118,183,83,26,79,185,148,167,61,59,36,154,156,124,133,96,157,138,45,188,87,66,126,20,146,50,53,51,29,143,55,106,71,69,190,43,128,85,164,111,159,40,37,145,189,33,13,172,67,25,109,141,35,32,91,180,88,78,171,152,57,186,113,196,89,24,198,28,74,4,97,131,0,199,62,44,34,108,6,21,155,184,161,80,58,177,169,191,11,104,46,163,170,95,31,90,125,149,120,68,63,100,116,175,176,193,16,136,144,70,19,64,103,112,84,77,115,179,60,42,47,132,165,119,48];539;True
3419;7048;10467;[82,187,130,22,37,138,178,117,2,41,3,176,12,132,193,109,66,157,103,105,45,188,93,87,6,149,167,61,21,180,72,154,77,128,42,57,26,121,162,126,143,160,136,1,33,124,94,196,36,182,140,34,147,23,189,81,0,85,104,31,74,194,146,144,170,95,38,139,165,46,51,50,174,118,19,123,90,67,32,91,163,25,70,65,16,190,11,113,156,71,8,184,20,191,173,18,131,110,101,59,80,100,30,134,148,195,97,58,175,151,7,102,181,68,198,142,137,158,54,52,119,49,39,107,55,14,13,111,112,89,75,84,15,135,53,183,69,159,164,9,28,155,73,99,106,4,115,152,35,161,172,86,133,76,122,116,44,125,145,56,92,108,192,40,169,129,29,78,60,177,27,43,127,96,171,141,98,114,64,79,179,47,88,5,186,199,83,153,166,24,150,10,185,62,120,197,168,17,48,63];540;False
1823;8197;10020;[194,56,92,41,166,5,27,150,93,105,99,73,140,178,192,10,123,17,8,94,173,18,158,129,162,197,15,135,14,49,195,117,182,65,9,147,130,22,38,139,72,1,75,151,7,153,187,127,39,107,76,122,102,114,101,110,30,134,137,86,181,82,23,12,54,142,121,168,3,98,160,2,81,52,174,118,183,83,26,79,185,148,167,61,59,36,154,156,124,133,96,157,138,45,188,87,66,126,20,146,50,53,51,29,143,55,106,71,69,190,43,128,85,164,111,159,40,37,145,189,33,13,172,67,25,109,141,35,32,91,180,88,78,171,152,57,186,113,196,89,24,198,28,74,4,97,131,0,199,62,44,34,108,6,21,155,184,161,80,58,177,169,191,11,104,46,163,170,95,31,90,125,149,120,68,63,100,116,175,176,193,16,136,144,70,19,64,103,112,84,77,115,179,60,42,47,132,165,119,48];541;True
3312;7056;10368;[82,77,130,22,37,138,178,117,2,41,3,176,12,132,193,109,66,157,103,105,45,188,93,87,6,149,167,61,21,180,72,154,187,128,42,57,26,121,162,126,143,160,136,1,33,124,94,196,36,182,140,34,147,23,189,81,0,85,104,31,74,194,146,144,170,95,38,139,165,46,51,50,174,118,19,123,90,67,32,91,163,25,70,65,16,190,11,113,156,71,8,184,20,191,173,18,131,110,101,59,80,100,30,134,148,195,97,58,175,151,7,102,181,68,198,142,137,158,54,52,119,49,39,107,55,14,13,111,112,89,75,84,15,135,53,183,69,159,164,9,28,155,73,99,106,4,115,152,35,161,172,86,133,76,122,116,44,125,145,56,92,108,192,40,169,129,29,78,60,177,27,43,127,96,171,141,98,114,64,79,179,47,88,5,186,199,83,153,166,24,150,10,185,62,120,197,168,17,48,63];542;True
1952;8159;10111;[194,56,92,41,166,5,27,197,93,105,99,73,140,178,192,10,123,17,8,94,173,18,158,129,162,150,15,135,14,49,195,117,182,65,9,147,130,22,38,139,72,1,75,151,7,153,187,127,39,107,76,122,102,114,101,110,30,134,137,86,181,82,23,12,54,142,121,168,3,98,160,2,81,52,174,118,183,83,26,79,185,148,167,61,59,36,154,156,124,133,96,157,138,45,188,87,66,126,20,146,50,53,51,29,143,55,106,71,69,190,43,128,85,164,111,159,40,37,145,189,33,13,172,67,25,109,141,35,32,91,180,88,78,171,152,57,186,113,196,89,24,198,28,74,4,97,131,0,199,62,44,34,108,6,21,155,184,161,80,58,177,169,191,11,104,46,163,170,95,31,90,125,149,120,68,63,100,116,175,176,193,16,136,144,70,19,64,103,112,84,77,115,179,60,42,47,132,165,119,48];543;False
3263;7061;10324;[82,12,130,22,37,138,178,117,2,41,3,176,77,132,193,109,66,157,103,105,45,188,93,87,6,149,167,61,21,180,72,154,187,128,42,57,26,121,162,126,143,160,136,1,33,124,94,196,36,182,140,34,147,23,189,81,0,85,104,31,74,194,146,144,170,95,38,139,165,46,51,50,174,118,19,123,90,67,32,91,163,25,70,65,16,190,11,113,156,71,8,184,20,191,173,18,131,110,101,59,80,100,30,134,148,195,97,58,175,151,7,102,181,68,198,142,137,158,54,52,119,49,39,107,55,14,13,111,112,89,75,84,15,135,53,183,69,159,164,9,28,155,73,99,106,4,115,152,35,161,172,86,133,76,122,116,44,125,145,56,92,108,192,40,169,129,29,78,60,177,27,43,127,96,171,141,98,114,64,79,179,47,88,5,186,199,83,153,166,24,150,10,185,62,120,197,168,17,48,63];544;True
1976;8146;10122;[194,56,92,41,166,5,27,197,162,105,99,73,140,178,192,10,123,17,8,94,173,18,158,129,93,150,15,135,14,49,195,117,182,65,9,147,130,22,38,139,72,1,75,151,7,153,187,127,39,107,76,122,102,114,101,110,30,134,137,86,181,82,23,12,54,142,121,168,3,98,160,2,81,52,174,118,183,83,26,79,185,148,167,61,59,36,154,156,124,133,96,157,138,45,188,87,66,126,20,146,50,53,51,29,143,55,106,71,69,190,43,128,85,164,111,159,40,37,145,189,33,13,172,67,25,109,141,35,32,91,180,88,78,171,152,57,186,113,196,89,24,198,28,74,4,97,131,0,199,62,44,34,108,6,21,155,184,161,80,58,177,169,191,11,104,46,163,170,95,31,90,125,149,120,68,63,100,116,175,176,193,16,136,144,70,19,64,103,112,84,77,115,179,60,42,47,132,165,119,48];545;False
3339;7048;10387;[82,131,130,22,37,138,178,117,2,41,3,176,77,132,193,109,66,157,103,105,45,188,93,87,6,149,167,61,21,180,72,154,187,128,42,57,26,121,162,126,143,160,136,1,33,124,94,196,36,182,140,34,147,23,189,81,0,85,104,31,74,194,146,144,170,95,38,139,165,46,51,50,174,118,19,123,90,67,32,91,163,25,70,65,16,190,11,113,156,71,8,184,20,191,173,18,12,110,101,59,80,100,30,134,148,195,97,58,175,151,7,102,181,68,198,142,137,158,54,52,119,49,39,107,55,14,13,111,112,89,75,84,15,135,53,183,69,159,164,9,28,155,73,99,106,4,115,152,35,161,172,86,133,76,122,116,44,125,145,56,92,108,192,40,169,129,29,78,60,177,27,43,127,96,171,141,98,114,64,79,179,47,88,5,186,199,83,153,166,24,150,10,185,62,120,197,168,17,48,63];546;True
1883;8159;10042;[194,56,92,41,166,5,27,197,150,105,99,73,140,178,192,10,123,17,8,94,173,18,158,129,93,162,15,135,14,49,195,117,182,65,9,147,130,22,38,139,72,1,75,151,7,153,187,127,39,107,76,122,102,114,101,110,30,134,137,86,181,82,23,12,54,142,121,168,3,98,160,2,81,52,174,118,183,83,26,79,185,148,167,61,59,36,154,156,124,133,96,157,138,45,188,87,66,126,20,146,50,53,51,29,143,55,106,71,69,190,43,128,85,164,111,159,40,37,145,189,33,13,172,67,25,109,141,35,32,91,180,88,78,171,152,57,186,113,196,89,24,198,28,74,4,97,131,0,199,62,44,34,108,6,21,155,184,161,80,58,177,169,191,11,104,46,163,170,95,31,90,125,149,120,68,63,100,116,175,176,193,16,136,144,70,19,64,103,112,84,77,115,179,60,42,47,132,165,119,48];547;False
3366;7045;10411;[90,131,130,22,37,138,178,117,2,41,3,176,77,132,193,109,66,157,103,105,45,188,93,87,6,149,167,61,21,180,72,154,187,128,42,57,26,121,162,126,143,160,136,1,33,124,94,196,36,182,140,34,147,23,189,81,0,85,104,31,74,194,146,144,170,95,38,139,165,46,51,50,174,118,19,123,82,67,32,91,163,25,70,65,16,190,11,113,156,71,8,184,20,191,173,18,12,110,101,59,80,100,30,134,148,195,97,58,175,151,7,102,181,68,198,142,137,158,54,52,119,49,39,107,55,14,13,111,112,89,75,84,15,135,53,183,69,159,164,9,28,155,73,99,106,4,115,152,35,161,172,86,133,76,122,116,44,125,145,56,92,108,192,40,169,129,29,78,60,177,27,43,127,96,171,141,98,114,64,79,179,47,88,5,186,199,83,153,166,24,150,10,185,62,120,197,168,17,48,63];548;True
1961;8148;10109;[194,56,92,41,187,5,27,197,150,105,99,73,140,178,192,10,123,17,8,94,173,18,158,129,93,162,15,135,14,49,195,117,182,65,9,147,130,22,38,139,72,1,75,151,7,153,166,127,39,107,76,122,102,114,101,110,30,134,137,86,181,82,23,12,54,142,121,168,3,98,160,2,81,52,174,118,183,83,26,79,185,148,167,61,59,36,154,156,124,133,96,157,138,45,188,87,66,126,20,146,50,53,51,29,143,55,106,71,69,190,43,128,85,164,111,159,40,37,145,189,33,13,172,67,25,109,141,35,32,91,180,88,78,171,152,57,186,113,196,89,24,198,28,74,4,97,131,0,199,62,44,34,108,6,21,155,184,161,80,58,177,169,191,11,104,46,163,170,95,31,90,125,149,120,68,63,100,116,175,176,193,16,136,144,70,19,64,103,112,84,77,115,179,60,42,47,132,165,119,48];549;False
3512;7040;10552;[154,131,130,22,37,138,178,117,2,41,3,176,77,132,193,109,66,157,103,105,45,188,93,87,6,149,167,61,21,180,72,90,187,128,42,57,26,121,162,126,143,160,136,1,33,124,94,196,36,182,140,34,147,23,189,81,0,85,104,31,74,194,146,144,170,95,38,139,165,46,51,50,174,118,19,123,82,67,32,91,163,25,70,65,16,190,11,113,156,71,8,184,20,191,173,18,12,110,101,59,80,100,30,134,148,195,97,58,175,151,7,102,181,68,198,142,137,158,54,52,119,49,39,107,55,14,13,111,112,89,75,84,15,135,53,183,69,159,164,9,28,155,73,99,106,4,115,152,35,161,172,86,133,76,122,116,44,125,145,56,92,108,192,40,169,129,29,78,60,177,27,43,127,96,171,141,98,114,64,79,179,47,88,5,186,199,83,153,166,24,150,10,185,62,120,197,168,17,48,63];550;False
1973;8140;10113;[194,56,92,41,187,5,27,197,150,105,99,73,140,178,192,10,123,17,8,94,173,18,158,129,156,162,15,135,14,49,195,117,182,65,9,147,130,22,38,139,72,1,75,151,7,153,166,127,39,107,76,122,102,114,101,110,30,134,137,86,181,82,23,12,54,142,121,168,3,98,160,2,81,52,174,118,183,83,26,79,185,148,167,61,59,36,154,93,124,133,96,157,138,45,188,87,66,126,20,146,50,53,51,29,143,55,106,71,69,190,43,128,85,164,111,159,40,37,145,189,33,13,172,67,25,109,141,35,32,91,180,88,78,171,152,57,186,113,196,89,24,198,28,74,4,97,131,0,199,62,44,34,108,6,21,155,184,161,80,58,177,169,191,11,104,46,163,170,95,31,90,125,149,120,68,63,100,116,175,176,193,16,136,144,70,19,64,103,112,84,77,115,179,60,42,47,132,165,119,48];551;False
3528;7036;10564;[84,131,130,22,37,138,178,117,2,41,3,176,77,132,193,109,66,157,103,105,45,188,93,87,6,149,167,61,21,180,72,90,187,128,42,57,26,121,162,126,143,160,136,1,33,124,94,196,36,182,140,34,147,23,189,81,0,85,104,31,74,194,146,144,170,95,38,139,165,46,51,50,174,118,19,123,82,67,32,91,163,25,70,65,16,190,11,113,156,71,8,184,20,191,173,18,12,110,101,59,80,100,30,134,148,195,97,58,175,151,7,102,181,68,198,142,137,158,54,52,119,49,39,107,55,14,13,111,112,89,75,154,15,135,53,183,69,159,164,9,28,155,73,99,106,4,115,152,35,161,172,86,133,76,122,116,44,125,145,56,92,108,192,40,169,129,29,78,60,177,27,43,127,96,171,141,98,114,64,79,179,47,88,5,186,199,83,153,166,24,150,10,185,62,120,197,168,17,48,63];552;False
1955;8158;10113;[194,56,92,124,187,5,27,197,150,105,99,73,140,178,192,10,123,17,8,94,173,18,158,129,156,162,15,135,14,49,195,117,182,65,9,147,130,22,38,139,72,1,75,151,7,153,166,127,39,107,76,122,102,114,101,110,30,134,137,86,181,82,23,12,54,142,121,168,3,98,160,2,81,52,174,118,183,83,26,79,185,148,167,61,59,36,154,93,41,133,96,157,138,45,188,87,66,126,20,146,50,53,51,29,143,55,106,71,69,190,43,128,85,164,111,159,40,37,145,189,33,13,172,67,25,109,141,35,32,91,180,88,78,171,152,57,186,113,196,89,24,198,28,74,4,97,131,0,199,62,44,34,108,6,21,155,184,161,80,58,177,169,191,11,104,46,163,170,95,31,90,125,149,120,68,63,100,116,175,176,193,16,136,144,70,19,64,103,112,84,77,115,179,60,42,47,132,165,119,48];553;False
3504;7039;10543;[84,131,130,22,26,138,178,117,2,41,3,176,77,132,193,109,66,157,103,105,45,188,93,87,6,149,167,61,21,180,72,90,187,128,42,57,37,121,162,126,143,160,136,1,33,124,94,196,36,182,140,34,147,23,189,81,0,85,104,31,74,194,146,144,170,95,38,139,165,46,51,50,174,118,19,123,82,67,32,91,163,25,70,65,16,190,11,113,156,71,8,184,20,191,173,18,12,110,101,59,80,100,30,134,148,195,97,58,175,151,7,102,181,68,198,142,137,158,54,52,119,49,39,107,55,14,13,111,112,89,75,154,15,135,53,183,69,159,164,9,28,155,73,99,106,4,115,152,35,161,172,86,133,76,122,116,44,125,145,56,92,108,192,40,169,129,29,78,60,177,27,43,127,96,171,141,98,114,64,79,179,47,88,5,186,199,83,153,166,24,150,10,185,62,120,197,168,17,48,63];554;True
1952;8143;10095;[194,56,92,9,187,5,27,197,150,105,99,73,140,178,192,10,123,17,8,94,173,18,158,129,156,162,15,135,14,49,195,117,182,65,124,147,130,22,38,139,72,1,75,151,7,153,166,127,39,107,76,122,102,114,101,110,30,134,137,86,181,82,23,12,54,142,121,168,3,98,160,2,81,52,174,118,183,83,26,79,185,148,167,61,59,36,154,93,41,133,96,157,138,45,188,87,66,126,20,146,50,53,51,29,143,55,106,71,69,190,43,128,85,164,111,159,40,37,145,189,33,13,172,67,25,109,141,35,32,91,180,88,78,171,152,57,186,113,196,89,24,198,28,74,4,97,131,0,199,62,44,34,108,6,21,155,184,161,80,58,177,169,191,11,104,46,163,170,95,31,90,125,149,120,68,63,100,116,175,176,193,16,136,144,70,19,64,103,112,84,77,115,179,60,42,47,132,165,119,48];555;False
3524;7032;10556;[84,100,130,22,26,138,178,117,2,41,3,176,77,132,193,109,66,157,103,105,45,188,93,87,6,149,167,61,21,180,72,90,187,128,42,57,37,121,162,126,143,160,136,1,33,124,94,196,36,182,140,34,147,23,189,81,0,85,104,31,74,194,146,144,170,95,38,139,165,46,51,50,174,118,19,123,82,67,32,91,163,25,70,65,16,190,11,113,156,71,8,184,20,191,173,18,12,110,101,59,80,131,30,134,148,195,97,58,175,151,7,102,181,68,198,142,137,158,54,52,119,49,39,107,55,14,13,111,112,89,75,154,15,135,53,183,69,159,164,9,28,155,73,99,106,4,115,152,35,161,172,86,133,76,122,116,44,125,145,56,92,108,192,40,169,129,29,78,60,177,27,43,127,96,171,141,98,114,64,79,179,47,88,5,186,199,83,153,166,24,150,10,185,62,120,197,168,17,48,63];556;True
1968;8131;10099;[194,56,28,9,187,5,27,197,150,105,99,73,140,178,192,10,123,17,8,94,173,18,158,129,156,162,15,135,14,49,195,117,182,65,124,147,130,22,38,139,72,1,75,151,7,153,166,127,39,107,76,122,102,114,101,110,30,134,137,86,181,82,23,12,54,142,121,168,3,98,160,2,81,52,174,118,183,83,26,79,185,148,167,61,59,36,154,93,41,133,96,157,138,45,188,87,66,126,20,146,50,53,51,29,143,55,106,71,69,190,43,128,85,164,111,159,40,37,145,189,33,13,172,67,25,109,141,35,32,91,180,88,78,171,152,57,186,113,196,89,24,198,92,74,4,97,131,0,199,62,44,34,108,6,21,155,184,161,80,58,177,169,191,11,104,46,163,170,95,31,90,125,149,120,68,63,100,116,175,176,193,16,136,144,70,19,64,103,112,84,77,115,179,60,42,47,132,165,119,48];557;False
3548;7028;10576;[20,100,130,22,26,138,178,117,2,41,3,176,77,132,193,109,66,157,103,105,45,188,93,87,6,149,167,61,21,180,72,90,187,128,42,57,37,121,162,126,143,160,136,1,33,124,94,196,36,182,140,34,147,23,189,81,0,85,104,31,74,194,146,144,170,95,38,139,165,46,51,50,174,118,19,123,82,67,32,91,163,25,70,65,16,190,11,113,156,71,8,184,84,191,173,18,12,110,101,59,80,131,30,134,148,195,97,58,175,151,7,102,181,68,198,142,137,158,54,52,119,49,39,107,55,14,13,111,112,89,75,154,15,135,53,183,69,159,164,9,28,155,73,99,106,4,115,152,35,161,172,86,133,76,122,116,44,125,145,56,92,108,192,40,169,129,29,78,60,177,27,43,127,96,171,141,98,114,64,79,179,47,88,5,186,199,83,153,166,24,150,10,185,62,120,197,168,17,48,63];558;True
1945;8154;10099;[194,56,28,137,187,5,27,197,150,105,99,73,140,178,192,10,123,17,8,94,173,18,158,129,156,162,15,135,14,49,195,117,182,65,124,147,130,22,38,139,72,1,75,151,7,153,166,127,39,107,76,122,102,114,101,110,30,134,9,86,181,82,23,12,54,142,121,168,3,98,160,2,81,52,174,118,183,83,26,79,185,148,167,61,59,36,154,93,41,133,96,157,138,45,188,87,66,126,20,146,50,53,51,29,143,55,106,71,69,190,43,128,85,164,111,159,40,37,145,189,33,13,172,67,25,109,141,35,32,91,180,88,78,171,152,57,186,113,196,89,24,198,92,74,4,97,131,0,199,62,44,34,108,6,21,155,184,161,80,58,177,169,191,11,104,46,163,170,95,31,90,125,149,120,68,63,100,116,175,176,193,16,136,144,70,19,64,103,112,84,77,115,179,60,42,47,132,165,119,48];559;False
3623;7013;10636;[20,100,130,22,26,61,178,117,2,41,3,176,77,132,193,109,66,157,103,105,45,188,93,87,6,149,167,138,21,180,72,90,187,128,42,57,37,121,162,126,143,160,136,1,33,124,94,196,36,182,140,34,147,23,189,81,0,85,104,31,74,194,146,144,170,95,38,139,165,46,51,50,174,118,19,123,82,67,32,91,163,25,70,65,16,190,11,113,156,71,8,184,84,191,173,18,12,110,101,59,80,131,30,134,148,195,97,58,175,151,7,102,181,68,198,142,137,158,54,52,119,49,39,107,55,14,13,111,112,89,75,154,15,135,53,183,69,159,164,9,28,155,73,99,106,4,115,152,35,161,172,86,133,76,122,116,44,125,145,56,92,108,192,40,169,129,29,78,60,177,27,43,127,96,171,141,98,114,64,79,179,47,88,5,186,199,83,153,166,24,150,10,185,62,120,197,168,17,48,63];560;True
1902;8156;10058;[194,56,28,137,187,5,27,197,150,105,99,73,140,178,192,10,123,17,8,94,173,18,158,160,156,162,15,135,14,49,195,117,182,65,124,147,130,22,38,139,72,1,75,151,7,153,166,127,39,107,76,122,102,114,101,110,30,134,9,86,181,82,23,12,54,142,121,168,3,98,129,2,81,52,174,118,183,83,26,79,185,148,167,61,59,36,154,93,41,133,96,157,138,45,188,87,66,126,20,146,50,53,51,29,143,55,106,71,69,190,43,128,85,164,111,159,40,37,145,189,33,13,172,67,25,109,141,35,32,91,180,88,78,171,152,57,186,113,196,89,24,198,92,74,4,97,131,0,199,62,44,34,108,6,21,155,184,161,80,58,177,169,191,11,104,46,163,170,95,31,90,125,149,120,68,63,100,116,175,176,193,16,136,144,70,19,64,103,112,84,77,115,179,60,42,47,132,165,119,48];561;False
3755;6997;10752;[20,10,130,22,26,61,178,117,2,41,3,176,77,132,193,109,66,157,103,105,45,188,93,87,6,149,167,138,21,180,72,90,187,128,42,57,37,121,162,126,143,160,136,1,33,124,94,196,36,182,140,34,147,23,189,81,0,85,104,31,74,194,146,144,170,95,38,139,165,46,51,50,174,118,19,123,82,67,32,91,163,25,70,65,16,190,11,113,156,71,8,184,84,191,173,18,12,110,101,59,80,131,30,134,148,195,97,58,175,151,7,102,181,68,198,142,137,158,54,52,119,49,39,107,55,14,13,111,112,89,75,154,15,135,53,183,69,159,164,9,28,155,73,99,106,4,115,152,35,161,172,86,133,76,122,116,44,125,145,56,92,108,192,40,169,129,29,78,60,177,27,43,127,96,171,141,98,114,64,79,179,47,88,5,186,199,83,153,166,24,150,100,185,62,120,197,168,17,48,63];562;False
1958;8142;10100;[194,69,28,137,187,5,27,197,150,105,99,73,140,178,192,10,123,17,8,94,173,18,158,160,156,162,15,135,14,49,195,117,182,65,124,147,130,22,38,139,72,1,75,151,7,153,166,127,39,107,76,122,102,114,101,110,30,134,9,86,181,82,23,12,54,142,121,168,3,98,129,2,81,52,174,118,183,83,26,79,185,148,167,61,59,36,154,93,41,133,96,157,138,45,188,87,66,126,20,146,50,53,51,29,143,55,106,71,56,190,43,128,85,164,111,159,40,37,145,189,33,13,172,67,25,109,141,35,32,91,180,88,78,171,152,57,186,113,196,89,24,198,92,74,4,97,131,0,199,62,44,34,108,6,21,155,184,161,80,58,177,169,191,11,104,46,163,170,95,31,90,125,149,120,68,63,100,116,175,176,193,16,136,144,70,19,64,103,112,84,77,115,179,60,42,47,132,165,119,48];563;False
3725;6999;10724;[194,10,130,22,26,61,178,117,2,41,3,176,77,132,193,109,66,157,103,105,45,188,93,87,6,149,167,138,21,180,72,90,187,128,42,57,37,121,162,126,143,160,136,1,33,124,94,196,36,182,140,34,147,23,189,81,0,85,104,31,74,20,146,144,170,95,38,139,165,46,51,50,174,118,19,123,82,67,32,91,163,25,70,65,16,190,11,113,156,71,8,184,84,191,173,18,12,110,101,59,80,131,30,134,148,195,97,58,175,151,7,102,181,68,198,142,137,158,54,52,119,49,39,107,55,14,13,111,112,89,75,154,15,135,53,183,69,159,164,9,28,155,73,99,106,4,115,152,35,161,172,86,133,76,122,116,44,125,145,56,92,108,192,40,169,129,29,78,60,177,27,43,127,96,171,141,98,114,64,79,179,47,88,5,186,199,83,153,166,24,150,100,185,62,120,197,168,17,48,63];564;True
1908;8155;10063;[71,69,28,137,187,5,27,197,150,105,99,73,140,178,192,10,123,17,8,94,173,18,158,160,156,162,15,135,14,49,195,117,182,65,124,147,130,22,38,139,72,1,75,151,7,153,166,127,39,107,76,122,102,114,101,110,30,134,9,86,181,82,23,12,54,142,121,168,3,98,129,2,81,52,174,118,183,83,26,79,185,148,167,61,59,36,154,93,41,133,96,157,138,45,188,87,66,126,20,146,50,53,51,29,143,55,106,194,56,190,43,128,85,164,111,159,40,37,145,189,33,13,172,67,25,109,141,35,32,91,180,88,78,171,152,57,186,113,196,89,24,198,92,74,4,97,131,0,199,62,44,34,108,6,21,155,184,161,80,58,177,169,191,11,104,46,163,170,95,31,90,125,149,120,68,63,100,116,175,176,193,16,136,144,70,19,64,103,112,84,77,115,179,60,42,47,132,165,119,48];565;False
3698;7006;10704;[4,10,130,22,26,61,178,117,2,41,3,176,77,132,193,109,66,157,103,105,45,188,93,87,6,149,167,138,21,180,72,90,187,128,42,57,37,121,162,126,143,160,136,1,33,124,94,196,36,182,140,34,147,23,189,81,0,85,104,31,74,20,146,144,170,95,38,139,165,46,51,50,174,118,19,123,82,67,32,91,163,25,70,65,16,190,11,113,156,71,8,184,84,191,173,18,12,110,101,59,80,131,30,134,148,195,97,58,175,151,7,102,181,68,198,142,137,158,54,52,119,49,39,107,55,14,13,111,112,89,75,154,15,135,53,183,69,159,164,9,28,155,73,99,106,194,115,152,35,161,172,86,133,76,122,116,44,125,145,56,92,108,192,40,169,129,29,78,60,177,27,43,127,96,171,141,98,114,64,79,179,47,88,5,186,199,83,153,166,24,150,100,185,62,120,197,168,17,48,63];566;True
1888;8157;10045;[156,69,28,137,187,5,27,197,150,105,99,73,140,178,192,10,123,17,8,94,173,18,158,160,71,162,15,135,14,49,195,117,182,65,124,147,130,22,38,139,72,1,75,151,7,153,166,127,39,107,76,122,102,114,101,110,30,134,9,86,181,82,23,12,54,142,121,168,3,98,129,2,81,52,174,118,183,83,26,79,185,148,167,61,59,36,154,93,41,133,96,157,138,45,188,87,66,126,20,146,50,53,51,29,143,55,106,194,56,190,43,128,85,164,111,159,40,37,145,189,33,13,172,67,25,109,141,35,32,91,180,88,78,171,152,57,186,113,196,89,24,198,92,74,4,97,131,0,199,62,44,34,108,6,21,155,184,161,80,58,177,169,191,11,104,46,163,170,95,31,90,125,149,120,68,63,100,116,175,176,193,16,136,144,70,19,64,103,112,84,77,115,179,60,42,47,132,165,119,48];567;False
3669;7007;10676;[4,136,130,22,26,61,178,117,2,41,3,176,77,132,193,109,66,157,103,105,45,188,93,87,6,149,167,138,21,180,72,90,187,128,42,57,37,121,162,126,143,160,10,1,33,124,94,196,36,182,140,34,147,23,189,81,0,85,104,31,74,20,146,144,170,95,38,139,165,46,51,50,174,118,19,123,82,67,32,91,163,25,70,65,16,190,11,113,156,71,8,184,84,191,173,18,12,110,101,59,80,131,30,134,148,195,97,58,175,151,7,102,181,68,198,142,137,158,54,52,119,49,39,107,55,14,13,111,112,89,75,154,15,135,53,183,69,159,164,9,28,155,73,99,106,194,115,152,35,161,172,86,133,76,122,116,44,125,145,56,92,108,192,40,169,129,29,78,60,177,27,43,127,96,171,141,98,114,64,79,179,47,88,5,186,199,83,153,166,24,150,100,185,62,120,197,168,17,48,63];568;True
1965;8141;10106;[143,69,28,137,187,5,27,197,150,105,99,73,140,178,192,10,123,17,8,94,173,18,158,160,71,162,15,135,14,49,195,117,182,65,124,147,130,22,38,139,72,1,75,151,7,153,166,127,39,107,76,122,102,114,101,110,30,134,9,86,181,82,23,12,54,142,121,168,3,98,129,2,81,52,174,118,183,83,26,79,185,148,167,61,59,36,154,93,41,133,96,157,138,45,188,87,66,126,20,146,50,53,51,29,156,55,106,194,56,190,43,128,85,164,111,159,40,37,145,189,33,13,172,67,25,109,141,35,32,91,180,88,78,171,152,57,186,113,196,89,24,198,92,74,4,97,131,0,199,62,44,34,108,6,21,155,184,161,80,58,177,169,191,11,104,46,163,170,95,31,90,125,149,120,68,63,100,116,175,176,193,16,136,144,70,19,64,103,112,84,77,115,179,60,42,47,132,165,119,48];569;False
3768;6995;10763;[198,136,130,22,26,61,178,117,2,41,3,176,77,132,193,109,66,157,103,105,45,188,93,87,6,149,167,138,21,180,72,90,187,128,42,57,37,121,162,126,143,160,10,1,33,124,94,196,36,182,140,34,147,23,189,81,0,85,104,31,74,20,146,144,170,95,38,139,165,46,51,50,174,118,19,123,82,67,32,91,163,25,70,65,16,190,11,113,156,71,8,184,84,191,173,18,12,110,101,59,80,131,30,134,148,195,97,58,175,151,7,102,181,68,4,142,137,158,54,52,119,49,39,107,55,14,13,111,112,89,75,154,15,135,53,183,69,159,164,9,28,155,73,99,106,194,115,152,35,161,172,86,133,76,122,116,44,125,145,56,92,108,192,40,169,129,29,78,60,177,27,43,127,96,171,141,98,114,64,79,179,47,88,5,186,199,83,153,166,24,150,100,185,62,120,197,168,17,48,63];570;False
1960;8141;10101;[4,69,28,137,187,5,27,197,150,105,99,73,140,178,192,10,123,17,8,94,173,18,158,160,71,162,15,135,14,49,195,117,182,65,124,147,130,22,38,139,72,1,75,151,7,153,166,127,39,107,76,122,102,114,101,110,30,134,9,86,181,82,23,12,54,142,121,168,3,98,129,2,81,52,174,118,183,83,26,79,185,148,167,61,59,36,154,93,41,133,96,157,138,45,188,87,66,126,20,146,50,53,51,29,156,55,106,194,56,190,43,128,85,164,111,159,40,37,145,189,33,13,172,67,25,109,141,35,32,91,180,88,78,171,152,57,186,113,196,89,24,198,92,74,143,97,131,0,199,62,44,34,108,6,21,155,184,161,80,58,177,169,191,11,104,46,163,170,95,31,90,125,149,120,68,63,100,116,175,176,193,16,136,144,70,19,64,103,112,84,77,115,179,60,42,47,132,165,119,48];571;False
3891;6991;10882;[198,6,130,22,26,61,178,117,2,41,3,176,77,132,193,109,66,157,103,105,45,188,93,87,136,149,167,138,21,180,72,90,187,128,42,57,37,121,162,126,143,160,10,1,33,124,94,196,36,182,140,34,147,23,189,81,0,85,104,31,74,20,146,144,170,95,38,139,165,46,51,50,174,118,19,123,82,67,32,91,163,25,70,65,16,190,11,113,156,71,8,184,84,191,173,18,12,110,101,59,80,131,30,134,148,195,97,58,175,151,7,102,181,68,4,142,137,158,54,52,119,49,39,107,55,14,13,111,112,89,75,154,15,135,53,183,69,159,164,9,28,155,73,99,106,194,115,152,35,161,172,86,133,76,122,116,44,125,145,56,92,108,192,40,169,129,29,78,60,177,27,43,127,96,171,141,98,114,64,79,179,47,88,5,186,199,83,153,166,24,150,100,185,62,120,197,168,17,48,63];572;False
1983;8118;10101;[4,69,28,9,187,5,27,197,150,105,99,73,140,178,192,10,123,17,8,94,173,18,158,160,71,162,15,135,14,49,195,117,182,65,124,147,130,22,38,139,72,1,75,151,7,153,166,127,39,107,76,122,102,114,101,110,30,134,137,86,181,82,23,12,54,142,121,168,3,98,129,2,81,52,174,118,183,83,26,79,185,148,167,61,59,36,154,93,41,133,96,157,138,45,188,87,66,126,20,146,50,53,51,29,156,55,106,194,56,190,43,128,85,164,111,159,40,37,145,189,33,13,172,67,25,109,141,35,32,91,180,88,78,171,152,57,186,113,196,89,24,198,92,74,143,97,131,0,199,62,44,34,108,6,21,155,184,161,80,58,177,169,191,11,104,46,163,170,95,31,90,125,149,120,68,63,100,116,175,176,193,16,136,144,70,19,64,103,112,84,77,115,179,60,42,47,132,165,119,48];573;False
3857;6992;10849;[198,10,130,22,26,61,178,117,2,41,3,176,77,132,193,109,66,157,103,105,45,188,93,87,136,149,167,138,21,180,72,90,187,128,42,57,37,121,162,126,143,160,6,1,33,124,94,196,36,182,140,34,147,23,189,81,0,85,104,31,74,20,146,144,170,95,38,139,165,46,51,50,174,118,19,123,82,67,32,91,163,25,70,65,16,190,11,113,156,71,8,184,84,191,173,18,12,110,101,59,80,131,30,134,148,195,97,58,175,151,7,102,181,68,4,142,137,158,54,52,119,49,39,107,55,14,13,111,112,89,75,154,15,135,53,183,69,159,164,9,28,155,73,99,106,194,115,152,35,161,172,86,133,76,122,116,44,125,145,56,92,108,192,40,169,129,29,78,60,177,27,43,127,96,171,141,98,114,64,79,179,47,88,5,186,199,83,153,166,24,150,100,185,62,120,197,168,17,48,63];574;False
1943;8143;10086;[4,69,28,154,187,5,27,197,150,105,99,73,140,178,192,10,123,17,8,94,173,18,158,160,71,162,15,135,14,49,195,117,182,65,124,147,130,22,38,139,72,1,75,151,7,153,166,127,39,107,76,122,102,114,101,110,30,134,137,86,181,82,23,12,54,142,121,168,3,98,129,2,81,52,174,118,183,83,26,79,185,148,167,61,59,36,9,93,41,133,96,157,138,45,188,87,66,126,20,146,50,53,51,29,156,55,106,194,56,190,43,128,85,164,111,159,40,37,145,189,33,13,172,67,25,109,141,35,32,91,180,88,78,171,152,57,186,113,196,89,24,198,92,74,143,97,131,0,199,62,44,34,108,6,21,155,184,161,80,58,177,169,191,11,104,46,163,170,95,31,90,125,149,120,68,63,100,116,175,176,193,16,136,144,70,19,64,103,112,84,77,115,179,60,42,47,132,165,119,48];575;False
3942;6988;10930;[198,146,130,22,26,61,178,117,2,41,3,176,77,132,193,109,66,157,103,105,45,188,93,87,136,149,167,138,21,180,72,90,187,128,42,57,37,121,162,126,143,160,6,1,33,124,94,196,36,182,140,34,147,23,189,81,0,85,104,31,74,20,10,144,170,95,38,139,165,46,51,50,174,118,19,123,82,67,32,91,163,25,70,65,16,190,11,113,156,71,8,184,84,191,173,18,12,110,101,59,80,131,30,134,148,195,97,58,175,151,7,102,181,68,4,142,137,158,54,52,119,49,39,107,55,14,13,111,112,89,75,154,15,135,53,183,69,159,164,9,28,155,73,99,106,194,115,152,35,161,172,86,133,76,122,116,44,125,145,56,92,108,192,40,169,129,29,78,60,177,27,43,127,96,171,141,98,114,64,79,179,47,88,5,186,199,83,153,166,24,150,100,185,62,120,197,168,17,48,63];576;False
1954;8127;10081;[4,69,28,14,187,5,27,197,150,105,99,73,140,178,192,10,123,17,8,94,173,18,158,160,71,162,15,135,154,49,195,117,182,65,124,147,130,22,38,139,72,1,75,151,7,153,166,127,39,107,76,122,102,114,101,110,30,134,137,86,181,82,23,12,54,142,121,168,3,98,129,2,81,52,174,118,183,83,26,79,185,148,167,61,59,36,9,93,41,133,96,157,138,45,188,87,66,126,20,146,50,53,51,29,156,55,106,194,56,190,43,128,85,164,111,159,40,37,145,189,33,13,172,67,25,109,141,35,32,91,180,88,78,171,152,57,186,113,196,89,24,198,92,74,143,97,131,0,199,62,44,34,108,6,21,155,184,161,80,58,177,169,191,11,104,46,163,170,95,31,90,125,149,120,68,63,100,116,175,176,193,16,136,144,70,19,64,103,112,84,77,115,179,60,42,47,132,165,119,48];577;False
4043;6972;11015;[198,180,130,22,26,61,178,117,2,41,3,176,77,132,193,109,66,157,103,105,45,188,93,87,136,149,167,138,21,146,72,90,187,128,42,57,37,121,162,126,143,160,6,1,33,124,94,196,36,182,140,34,147,23,189,81,0,85,104,31,74,20,10,144,170,95,38,139,165,46,51,50,174,118,19,123,82,67,32,91,163,25,70,65,16,190,11,113,156,71,8,184,84,191,173,18,12,110,101,59,80,131,30,134,148,195,97,58,175,151,7,102,181,68,4,142,137,158,54,52,119,49,39,107,55,14,13,111,112,89,75,154,15,135,53,183,69,159,164,9,28,155,73,99,106,194,115,152,35,161,172,86,133,76,122,116,44,125,145,56,92,108,192,40,169,129,29,78,60,177,27,43,127,96,171,141,98,114,64,79,179,47,88,5,186,199,83,153,166,24,150,100,185,62,120,197,168,17,48,63];578;False
1940;8134;10074;[4,69,28,14,166,5,27,197,150,105,99,73,140,178,192,10,123,17,8,94,173,18,158,160,71,162,15,135,154,49,195,117,182,65,124,147,130,22,38,139,72,1,75,151,7,153,187,127,39,107,76,122,102,114,101,110,30,134,137,86,181,82,23,12,54,142,121,168,3,98,129,2,81,52,174,118,183,83,26,79,185,148,167,61,59,36,9,93,41,133,96,157,138,45,188,87,66,126,20,146,50,53,51,29,156,55,106,194,56,190,43,128,85,164,111,159,40,37,145,189,33,13,172,67,25,109,141,35,32,91,180,88,78,171,152,57,186,113,196,89,24,198,92,74,143,97,131,0,199,62,44,34,108,6,21,155,184,161,80,58,177,169,191,11,104,46,163,170,95,31,90,125,149,120,68,63,100,116,175,176,193,16,136,144,70,19,64,103,112,84,77,115,179,60,42,47,132,165,119,48];579;False
3981;6975;10956;[50,180,130,22,26,61,178,117,2,41,3,176,77,132,193,109,66,157,103,105,45,188,93,87,136,149,167,138,21,146,72,90,187,128,42,57,37,121,162,126,143,160,6,1,33,124,94,196,36,182,140,34,147,23,189,81,0,85,104,31,74,20,10,144,170,95,38,139,165,46,51,198,174,118,19,123,82,67,32,91,163,25,70,65,16,190,11,113,156,71,8,184,84,191,173,18,12,110,101,59,80,131,30,134,148,195,97,58,175,151,7,102,181,68,4,142,137,158,54,52,119,49,39,107,55,14,13,111,112,89,75,154,15,135,53,183,69,159,164,9,28,155,73,99,106,194,115,152,35,161,172,86,133,76,122,116,44,125,145,56,92,108,192,40,169,129,29,78,60,177,27,43,127,96,171,141,98,114,64,79,179,47,88,5,186,199,83,153,166,24,150,100,185,62,120,197,168,17,48,63];580;False
1929;8129;10058;[4,69,14,28,166,5,27,197,150,105,99,73,140,178,192,10,123,17,8,94,173,18,158,160,71,162,15,135,154,49,195,117,182,65,124,147,130,22,38,139,72,1,75,151,7,153,187,127,39,107,76,122,102,114,101,110,30,134,137,86,181,82,23,12,54,142,121,168,3,98,129,2,81,52,174,118,183,83,26,79,185,148,167,61,59,36,9,93,41,133,96,157,138,45,188,87,66,126,20,146,50,53,51,29,156,55,106,194,56,190,43,128,85,164,111,159,40,37,145,189,33,13,172,67,25,109,141,35,32,91,180,88,78,171,152,57,186,113,196,89,24,198,92,74,143,97,131,0,199,62,44,34,108,6,21,155,184,161,80,58,177,169,191,11,104,46,163,170,95,31,90,125,149,120,68,63,100,116,175,176,193,16,136,144,70,19,64,103,112,84,77,115,179,60,42,47,132,165,119,48];581;False
4042;6959;11001;[50,19,130,22,26,61,178,117,2,41,3,176,77,132,193,109,66,157,103,105,45,188,93,87,136,149,167,138,21,146,72,90,187,128,42,57,37,121,162,126,143,160,6,1,33,124,94,196,36,182,140,34,147,23,189,81,0,85,104,31,74,20,10,144,170,95,38,139,165,46,51,198,174,118,180,123,82,67,32,91,163,25,70,65,16,190,11,113,156,71,8,184,84,191,173,18,12,110,101,59,80,131,30,134,148,195,97,58,175,151,7,102,181,68,4,142,137,158,54,52,119,49,39,107,55,14,13,111,112,89,75,154,15,135,53,183,69,159,164,9,28,155,73,99,106,194,115,152,35,161,172,86,133,76,122,116,44,125,145,56,92,108,192,40,169,129,29,78,60,177,27,43,127,96,171,141,98,114,64,79,179,47,88,5,186,199,83,153,166,24,150,100,185,62,120,197,168,17,48,63];582;False
1996;8115;10111;[63,69,14,28,166,5,27,197,150,105,99,73,140,178,192,10,123,17,8,94,173,18,158,160,71,162,15,135,154,49,195,117,182,65,124,147,130,22,38,139,72,1,75,151,7,153,187,127,39,107,76,122,102,114,101,110,30,134,137,86,181,82,23,12,54,142,121,168,3,98,129,2,81,52,174,118,183,83,26,79,185,148,167,61,59,36,9,93,41,133,96,157,138,45,188,87,66,126,20,146,50,53,51,29,156,55,106,194,56,190,43,128,85,164,111,159,40,37,145,189,33,13,172,67,25,109,141,35,32,91,180,88,78,171,152,57,186,113,196,89,24,198,92,74,143,97,131,0,199,62,44,34,108,6,21,155,184,161,80,58,177,169,191,11,104,46,163,170,95,31,90,125,149,120,68,4,100,116,175,176,193,16,136,144,70,19,64,103,112,84,77,115,179,60,42,47,132,165,119,48];583;False
4146;6958;11104;[34,19,130,22,26,61,178,117,2,41,3,176,77,132,193,109,66,157,103,105,45,188,93,87,136,149,167,138,21,146,72,90,187,128,42,57,37,121,162,126,143,160,6,1,33,124,94,196,36,182,140,50,147,23,189,81,0,85,104,31,74,20,10,144,170,95,38,139,165,46,51,198,174,118,180,123,82,67,32,91,163,25,70,65,16,190,11,113,156,71,8,184,84,191,173,18,12,110,101,59,80,131,30,134,148,195,97,58,175,151,7,102,181,68,4,142,137,158,54,52,119,49,39,107,55,14,13,111,112,89,75,154,15,135,53,183,69,159,164,9,28,155,73,99,106,194,115,152,35,161,172,86,133,76,122,116,44,125,145,56,92,108,192,40,169,129,29,78,60,177,27,43,127,96,171,141,98,114,64,79,179,47,88,5,186,199,83,153,166,24,150,100,185,62,120,197,168,17,48,63];584;False
1958;8105;10063;[63,69,14,28,166,5,27,197,150,105,99,73,140,178,192,10,123,17,8,94,173,18,158,160,156,162,15,135,154,49,195,117,182,65,124,147,130,22,38,139,72,1,75,151,7,153,187,127,39,107,76,122,102,114,101,110,30,134,137,86,181,82,23,12,54,142,121,168,3,98,129,2,81,52,174,118,183,83,26,79,185,148,167,61,59,36,9,93,41,133,96,157,138,45,188,87,66,126,20,146,50,53,51,29,71,55,106,194,56,190,43,128,85,164,111,159,40,37,145,189,33,13,172,67,25,109,141,35,32,91,180,88,78,171,152,57,186,113,196,89,24,198,92,74,143,97,131,0,199,62,44,34,108,6,21,155,184,161,80,58,177,169,191,11,104,46,163,170,95,31,90,125,149,120,68,4,100,116,175,176,193,16,136,144,70,19,64,103,112,84,77,115,179,60,42,47,132,165,119,48];585;False
4064;6957;11021;[34,10,130,22,26,61,178,117,2,41,3,176,77,132,193,109,66,157,103,105,45,188,93,87,136,149,167,138,21,146,72,90,187,128,42,57,37,121,162,126,143,160,6,1,33,124,94,196,36,182,140,50,147,23,189,81,0,85,104,31,74,20,19,144,170,95,38,139,165,46,51,198,174,118,180,123,82,67,32,91,163,25,70,65,16,190,11,113,156,71,8,184,84,191,173,18,12,110,101,59,80,131,30,134,148,195,97,58,175,151,7,102,181,68,4,142,137,158,54,52,119,49,39,107,55,14,13,111,112,89,75,154,15,135,53,183,69,159,164,9,28,155,73,99,106,194,115,152,35,161,172,86,133,76,122,116,44,125,145,56,92,108,192,40,169,129,29,78,60,177,27,43,127,96,171,141,98,114,64,79,179,47,88,5,186,199,83,153,166,24,150,100,185,62,120,197,168,17,48,63];586;False
1891;8119;10010;[4,69,14,28,166,5,27,197,150,105,99,73,140,178,192,10,123,17,8,94,173,18,158,160,156,162,15,135,154,49,195,117,182,65,124,147,130,22,38,139,72,1,75,151,7,153,187,127,39,107,76,122,102,114,101,110,30,134,137,86,181,82,23,12,54,142,121,168,3,98,129,2,81,52,174,118,183,83,26,79,185,148,167,61,59,36,9,93,41,133,96,157,138,45,188,87,66,126,20,146,50,53,51,29,71,55,106,194,56,190,43,128,85,164,111,159,40,37,145,189,33,13,172,67,25,109,141,35,32,91,180,88,78,171,152,57,186,113,196,89,24,198,92,74,143,97,131,0,199,62,44,34,108,6,21,155,184,161,80,58,177,169,191,11,104,46,163,170,95,31,90,125,149,120,68,63,100,116,175,176,193,16,136,144,70,19,64,103,112,84,77,115,179,60,42,47,132,165,119,48];587;True
4010;6973;10983;[146,10,130,22,26,61,178,117,2,41,3,176,77,132,193,109,66,157,103,105,45,188,93,87,136,149,167,138,21,34,72,90,187,128,42,57,37,121,162,126,143,160,6,1,33,124,94,196,36,182,140,50,147,23,189,81,0,85,104,31,74,20,19,144,170,95,38,139,165,46,51,198,174,118,180,123,82,67,32,91,163,25,70,65,16,190,11,113,156,71,8,184,84,191,173,18,12,110,101,59,80,131,30,134,148,195,97,58,175,151,7,102,181,68,4,142,137,158,54,52,119,49,39,107,55,14,13,111,112,89,75,154,15,135,53,183,69,159,164,9,28,155,73,99,106,194,115,152,35,161,172,86,133,76,122,116,44,125,145,56,92,108,192,40,169,129,29,78,60,177,27,43,127,96,171,141,98,114,64,79,179,47,88,5,186,199,83,153,166,24,150,100,185,62,120,197,168,17,48,63];588;False
1870;8160;10030;[32,69,14,28,166,5,27,197,150,105,99,73,140,178,192,10,123,17,8,94,173,18,158,160,156,162,15,135,154,49,195,117,182,65,124,147,130,22,38,139,72,1,75,151,7,153,187,127,39,107,76,122,102,114,101,110,30,134,137,86,181,82,23,12,54,142,121,168,3,98,129,2,81,52,174,118,183,83,26,79,185,148,167,61,59,36,9,93,41,133,96,157,138,45,188,87,66,126,20,146,50,53,51,29,71,55,106,194,56,190,43,128,85,164,111,159,40,37,145,189,33,13,172,67,25,109,141,35,4,91,180,88,78,171,152,57,186,113,196,89,24,198,92,74,143,97,131,0,199,62,44,34,108,6,21,155,184,161,80,58,177,169,191,11,104,46,163,170,95,31,90,125,149,120,68,63,100,116,175,176,193,16,136,144,70,19,64,103,112,84,77,115,179,60,42,47,132,165,119,48];589;True
3968;6965;10933;[50,10,130,22,26,61,178,117,2,41,3,176,77,132,193,109,66,157,103,105,45,188,93,87,136,149,167,138,21,34,72,90,187,128,42,57,37,121,162,126,143,160,6,1,33,124,94,196,36,182,140,146,147,23,189,81,0,85,104,31,74,20,19,144,170,95,38,139,165,46,51,198,174,118,180,123,82,67,32,91,163,25,70,65,16,190,11,113,156,71,8,184,84,191,173,18,12,110,101,59,80,131,30,134,148,195,97,58,175,151,7,102,181,68,4,142,137,158,54,52,119,49,39,107,55,14,13,111,112,89,75,154,15,135,53,183,69,159,164,9,28,155,73,99,106,194,115,152,35,161,172,86,133,76,122,116,44,125,145,56,92,108,192,40,169,129,29,78,60,177,27,43,127,96,171,141,98,114,64,79,179,47,88,5,186,199,83,153,166,24,150,100,185,62,120,197,168,17,48,63];590;False
1871;8137;10008;[69,32,14,28,166,5,27,197,150,105,99,73,140,178,192,10,123,17,8,94,173,18,158,160,156,162,15,135,154,49,195,117,182,65,124,147,130,22,38,139,72,1,75,151,7,153,187,127,39,107,76,122,102,114,101,110,30,134,137,86,181,82,23,12,54,142,121,168,3,98,129,2,81,52,174,118,183,83,26,79,185,148,167,61,59,36,9,93,41,133,96,157,138,45,188,87,66,126,20,146,50,53,51,29,71,55,106,194,56,190,43,128,85,164,111,159,40,37,145,189,33,13,172,67,25,109,141,35,4,91,180,88,78,171,152,57,186,113,196,89,24,198,92,74,143,97,131,0,199,62,44,34,108,6,21,155,184,161,80,58,177,169,191,11,104,46,163,170,95,31,90,125,149,120,68,63,100,116,175,176,193,16,136,144,70,19,64,103,112,84,77,115,179,60,42,47,132,165,119,48];591;True
2015;8093;10108;[180,69,14,28,166,5,27,197,150,105,99,73,140,178,192,10,123,17,8,94,173,18,158,160,156,162,15,135,154,49,195,117,182,65,124,147,130,22,38,139,72,1,75,151,7,153,187,127,39,107,76,122,102,114,101,110,30,134,137,86,181,82,23,12,54,142,121,168,3,98,129,2,81,52,174,118,183,83,26,79,185,148,167,61,59,36,9,93,41,133,96,157,138,45,188,87,66,126,20,146,50,53,51,29,71,55,106,194,56,190,43,128,85,164,111,159,40,37,145,189,33,13,172,67,25,109,141,35,4,91,32,88,78,171,152,57,186,113,196,89,24,198,92,74,143,97,131,0,199,62,44,34,108,6,21,155,184,161,80,58,177,169,191,11,104,46,163,170,95,31,90,125,149,120,68,63,100,116,175,176,193,16,136,144,70,19,64,103,112,84,77,115,179,60,42,47,132,165,119,48];592;False
4020;6957;10977;[198,10,130,22,26,61,178,117,2,41,3,176,77,132,193,109,66,157,103,105,45,188,93,87,136,149,167,138,21,34,72,90,187,128,42,57,37,121,162,126,143,160,6,1,33,124,94,196,36,182,140,146,147,23,189,81,0,85,104,31,74,20,19,144,170,95,38,139,165,46,51,50,174,118,180,123,82,67,32,91,163,25,70,65,16,190,11,113,156,71,8,184,84,191,173,18,12,110,101,59,80,131,30,134,148,195,97,58,175,151,7,102,181,68,4,142,137,158,54,52,119,49,39,107,55,14,13,111,112,89,75,154,15,135,53,183,69,159,164,9,28,155,73,99,106,194,115,152,35,161,172,86,133,76,122,116,44,125,145,56,92,108,192,40,169,129,29,78,60,177,27,43,127,96,171,141,98,114,64,79,179,47,88,5,186,199,83,153,166,24,150,100,185,62,120,197,168,17,48,63];593;True
1889;8130;10019;[111,32,14,28,166,5,27,197,150,105,99,73,140,178,192,10,123,17,8,94,173,18,158,160,156,162,15,135,154,49,195,117,182,65,124,147,130,22,38,139,72,1,75,151,7,153,187,127,39,107,76,122,102,114,101,110,30,134,137,86,181,82,23,12,54,142,121,168,3,98,129,2,81,52,174,118,183,83,26,79,185,148,167,61,59,36,9,93,41,133,96,157,138,45,188,87,66,126,20,146,50,53,51,29,71,55,106,194,56,190,43,128,85,164,69,159,40,37,145,189,33,13,172,67,25,109,141,35,4,91,180,88,78,171,152,57,186,113,196,89,24,198,92,74,143,97,131,0,199,62,44,34,108,6,21,155,184,161,80,58,177,169,191,11,104,46,163,170,95,31,90,125,149,120,68,63,100,116,175,176,193,16,136,144,70,19,64,103,112,84,77,115,179,60,42,47,132,165,119,48];594;True
1987;8099;10086;[147,69,14,28,166,5,27,197,150,105,99,73,140,178,192,10,123,17,8,94,173,18,158,160,156,162,15,135,154,49,195,117,182,65,124,180,130,22,38,139,72,1,75,151,7,153,187,127,39,107,76,122,102,114,101,110,30,134,137,86,181,82,23,12,54,142,121,168,3,98,129,2,81,52,174,118,183,83,26,79,185,148,167,61,59,36,9,93,41,133,96,157,138,45,188,87,66,126,20,146,50,53,51,29,71,55,106,194,56,190,43,128,85,164,111,159,40,37,145,189,33,13,172,67,25,109,141,35,4,91,32,88,78,171,152,57,186,113,196,89,24,198,92,74,143,97,131,0,199,62,44,34,108,6,21,155,184,161,80,58,177,169,191,11,104,46,163,170,95,31,90,125,149,120,68,63,100,116,175,176,193,16,136,144,70,19,64,103,112,84,77,115,179,60,42,47,132,165,119,48];595;False
3967;6980;10947;[45,10,130,22,26,61,178,117,2,41,3,176,77,132,193,109,66,157,103,105,198,188,93,87,136,149,167,138,21,34,72,90,187,128,42,57,37,121,162,126,143,160,6,1,33,124,94,196,36,182,140,146,147,23,189,81,0,85,104,31,74,20,19,144,170,95,38,139,165,46,51,50,174,118,180,123,82,67,32,91,163,25,70,65,16,190,11,113,156,71,8,184,84,191,173,18,12,110,101,59,80,131,30,134,148,195,97,58,175,151,7,102,181,68,4,142,137,158,54,52,119,49,39,107,55,14,13,111,112,89,75,154,15,135,53,183,69,159,164,9,28,155,73,99,106,194,115,152,35,161,172,86,133,76,122,116,44,125,145,56,92,108,192,40,169,129,29,78,60,177,27,43,127,96,171,141,98,114,64,79,179,47,88,5,186,199,83,153,166,24,150,100,185,62,120,197,168,17,48,63];596;False
1909;8095;10004;[67,32,14,28,166,5,27,197,150,105,99,73,140,178,192,10,123,17,8,94,173,18,158,160,156,162,15,135,154,49,195,117,182,65,124,147,130,22,38,139,72,1,75,151,7,153,187,127,39,107,76,122,102,114,101,110,30,134,137,86,181,82,23,12,54,142,121,168,3,98,129,2,81,52,174,118,183,83,26,79,185,148,167,61,59,36,9,93,41,133,96,157,138,45,188,87,66,126,20,146,50,53,51,29,71,55,106,194,56,190,43,128,85,164,69,159,40,37,145,189,33,13,172,111,25,109,141,35,4,91,180,88,78,171,152,57,186,113,196,89,24,198,92,74,143,97,131,0,199,62,44,34,108,6,21,155,184,161,80,58,177,169,191,11,104,46,163,170,95,31,90,125,149,120,68,63,100,116,175,176,193,16,136,144,70,19,64,103,112,84,77,115,179,60,42,47,132,165,119,48];597;True
3966;6977;10943;[21,10,130,22,26,61,178,117,2,41,3,176,77,132,193,109,66,157,103,105,198,188,93,87,136,149,167,138,45,34,72,90,187,128,42,57,37,121,162,126,143,160,6,1,33,124,94,196,36,182,140,146,147,23,189,81,0,85,104,31,74,20,19,144,170,95,38,139,165,46,51,50,174,118,180,123,82,67,32,91,163,25,70,65,16,190,11,113,156,71,8,184,84,191,173,18,12,110,101,59,80,131,30,134,148,195,97,58,175,151,7,102,181,68,4,142,137,158,54,52,119,49,39,107,55,14,13,111,112,89,75,154,15,135,53,183,69,159,164,9,28,155,73,99,106,194,115,152,35,161,172,86,133,76,122,116,44,125,145,56,92,108,192,40,169,129,29,78,60,177,27,43,127,96,171,141,98,114,64,79,179,47,88,5,186,199,83,153,166,24,150,100,185,62,120,197,168,17,48,63];598;False
1968;8082;10050;[23,32,14,28,166,5,27,197,150,105,99,73,140,178,192,10,123,17,8,94,173,18,158,160,156,162,15,135,154,49,195,117,182,65,124,147,130,22,38,139,72,1,75,151,7,153,187,127,39,107,76,122,102,114,101,110,30,134,137,86,181,82,67,12,54,142,121,168,3,98,129,2,81,52,174,118,183,83,26,79,185,148,167,61,59,36,9,93,41,133,96,157,138,45,188,87,66,126,20,146,50,53,51,29,71,55,106,194,56,190,43,128,85,164,69,159,40,37,145,189,33,13,172,111,25,109,141,35,4,91,180,88,78,171,152,57,186,113,196,89,24,198,92,74,143,97,131,0,199,62,44,34,108,6,21,155,184,161,80,58,177,169,191,11,104,46,163,170,95,31,90,125,149,120,68,63,100,116,175,176,193,16,136,144,70,19,64,103,112,84,77,115,179,60,42,47,132,165,119,48];599;False
3932;6965;10897;[34,10,130,22,26,61,178,117,2,41,3,176,77,132,193,109,66,157,103,105,198,188,93,87,136,149,167,138,45,21,72,90,187,128,42,57,37,121,162,126,143,160,6,1,33,124,94,196,36,182,140,146,147,23,189,81,0,85,104,31,74,20,19,144,170,95,38,139,165,46,51,50,174,118,180,123,82,67,32,91,163,25,70,65,16,190,11,113,156,71,8,184,84,191,173,18,12,110,101,59,80,131,30,134,148,195,97,58,175,151,7,102,181,68,4,142,137,158,54,52,119,49,39,107,55,14,13,111,112,89,75,154,15,135,53,183,69,159,164,9,28,155,73,99,106,194,115,152,35,161,172,86,133,76,122,116,44,125,145,56,92,108,192,40,169,129,29,78,60,177,27,43,127,96,171,141,98,114,64,79,179,47,88,5,186,199,83,153,166,24,150,100,185,62,120,197,168,17,48,63];600;True
2037;8077;10114;[147,32,14,28,166,5,27,197,150,105,99,73,140,178,192,10,123,17,8,94,173,18,158,160,156,162,15,135,154,49,195,117,182,65,124,23,130,22,38,139,72,1,75,151,7,153,187,127,39,107,76,122,102,114,101,110,30,134,137,86,181,82,67,12,54,142,121,168,3,98,129,2,81,52,174,118,183,83,26,79,185,148,167,61,59,36,9,93,41,133,96,157,138,45,188,87,66,126,20,146,50,53,51,29,71,55,106,194,56,190,43,128,85,164,69,159,40,37,145,189,33,13,172,111,25,109,141,35,4,91,180,88,78,171,152,57,186,113,196,89,24,198,92,74,143,97,131,0,199,62,44,34,108,6,21,155,184,161,80,58,177,169,191,11,104,46,163,170,95,31,90,125,149,120,68,63,100,116,175,176,193,16,136,144,70,19,64,103,112,84,77,115,179,60,42,47,132,165,119,48];601;False
3801;6984;10785;[146,10,130,22,26,61,178,117,2,41,3,176,77,132,193,109,66,157,103,105,198,188,93,87,136,149,167,138,45,21,72,90,187,128,42,57,37,121,162,126,143,160,6,1,33,124,94,196,36,182,140,34,147,23,189,81,0,85,104,31,74,20,19,144,170,95,38,139,165,46,51,50,174,118,180,123,82,67,32,91,163,25,70,65,16,190,11,113,156,71,8,184,84,191,173,18,12,110,101,59,80,131,30,134,148,195,97,58,175,151,7,102,181,68,4,142,137,158,54,52,119,49,39,107,55,14,13,111,112,89,75,154,15,135,53,183,69,159,164,9,28,155,73,99,106,194,115,152,35,161,172,86,133,76,122,116,44,125,145,56,92,108,192,40,169,129,29,78,60,177,27,43,127,96,171,141,98,114,64,79,179,47,88,5,186,199,83,153,166,24,150,100,185,62,120,197,168,17,48,63];602;True
2065;8076;10141;[41,32,14,28,166,5,27,197,150,105,99,73,140,178,192,10,123,17,8,94,173,18,158,160,156,162,15,135,154,49,195,117,182,65,124,23,130,22,38,139,72,1,75,151,7,153,187,127,39,107,76,122,102,114,101,110,30,134,137,86,181,82,67,12,54,142,121,168,3,98,129,2,81,52,174,118,183,83,26,79,185,148,167,61,59,36,9,93,147,133,96,157,138,45,188,87,66,126,20,146,50,53,51,29,71,55,106,194,56,190,43,128,85,164,69,159,40,37,145,189,33,13,172,111,25,109,141,35,4,91,180,88,78,171,152,57,186,113,196,89,24,198,92,74,143,97,131,0,199,62,44,34,108,6,21,155,184,161,80,58,177,169,191,11,104,46,163,170,95,31,90,125,149,120,68,63,100,116,175,176,193,16,136,144,70,19,64,103,112,84,77,115,179,60,42,47,132,165,119,48];603;False
3740;6985;10725;[174,10,130,22,26,61,178,117,2,41,3,176,77,132,193,109,66,157,103,105,198,188,93,87,136,149,167,138,45,21,72,90,187,128,42,57,37,121,162,126,143,160,6,1,33,124,94,196,36,182,140,34,147,23,189,81,0,85,104,31,74,20,19,144,170,95,38,139,165,46,51,50,146,118,180,123,82,67,32,91,163,25,70,65,16,190,11,113,156,71,8,184,84,191,173,18,12,110,101,59,80,131,30,134,148,195,97,58,175,151,7,102,181,68,4,142,137,158,54,52,119,49,39,107,55,14,13,111,112,89,75,154,15,135,53,183,69,159,164,9,28,155,73,99,106,194,115,152,35,161,172,86,133,76,122,116,44,125,145,56,92,108,192,40,169,129,29,78,60,177,27,43,127,96,171,141,98,114,64,79,179,47,88,5,186,199,83,153,166,24,150,100,185,62,120,197,168,17,48,63];604;True
2041;8075;10116;[23,32,14,28,166,5,27,197,150,105,99,73,140,178,192,10,123,17,8,94,173,18,158,160,156,162,15,135,154,49,195,117,182,65,124,41,130,22,38,139,72,1,75,151,7,153,187,127,39,107,76,122,102,114,101,110,30,134,137,86,181,82,67,12,54,142,121,168,3,98,129,2,81,52,174,118,183,83,26,79,185,148,167,61,59,36,9,93,147,133,96,157,138,45,188,87,66,126,20,146,50,53,51,29,71,55,106,194,56,190,43,128,85,164,69,159,40,37,145,189,33,13,172,111,25,109,141,35,4,91,180,88,78,171,152,57,186,113,196,89,24,198,92,74,143,97,131,0,199,62,44,34,108,6,21,155,184,161,80,58,177,169,191,11,104,46,163,170,95,31,90,125,149,120,68,63,100,116,175,176,193,16,136,144,70,19,64,103,112,84,77,115,179,60,42,47,132,165,119,48];605;False
3827;6982;10809;[174,196,130,22,26,61,178,117,2,41,3,176,77,132,193,109,66,157,103,105,198,188,93,87,136,149,167,138,45,21,72,90,187,128,42,57,37,121,162,126,143,160,6,1,33,124,94,10,36,182,140,34,147,23,189,81,0,85,104,31,74,20,19,144,170,95,38,139,165,46,51,50,146,118,180,123,82,67,32,91,163,25,70,65,16,190,11,113,156,71,8,184,84,191,173,18,12,110,101,59,80,131,30,134,148,195,97,58,175,151,7,102,181,68,4,142,137,158,54,52,119,49,39,107,55,14,13,111,112,89,75,154,15,135,53,183,69,159,164,9,28,155,73,99,106,194,115,152,35,161,172,86,133,76,122,116,44,125,145,56,92,108,192,40,169,129,29,78,60,177,27,43,127,96,171,141,98,114,64,79,179,47,88,5,186,199,83,153,166,24,150,100,185,62,120,197,168,17,48,63];606;True
2004;8068;10072;[147,32,14,28,166,5,27,197,150,105,99,73,140,178,192,10,123,17,8,94,173,18,158,160,156,162,15,135,154,49,195,117,182,65,124,41,130,22,38,139,72,1,75,151,7,153,187,127,39,107,76,122,102,114,101,110,30,134,137,86,181,82,67,12,54,142,121,168,3,98,129,2,81,52,174,118,183,83,26,79,185,148,167,61,59,36,9,93,23,133,96,157,138,45,188,87,66,126,20,146,50,53,51,29,71,55,106,194,56,190,43,128,85,164,69,159,40,37,145,189,33,13,172,111,25,109,141,35,4,91,180,88,78,171,152,57,186,113,196,89,24,198,92,74,143,97,131,0,199,62,44,34,108,6,21,155,184,161,80,58,177,169,191,11,104,46,163,170,95,31,90,125,149,120,68,63,100,116,175,176,193,16,136,144,70,19,64,103,112,84,77,115,179,60,42,47,132,165,119,48];607;False
3859;6980;10839;[180,196,130,22,26,61,178,117,2,41,3,176,77,132,193,109,66,157,103,105,198,188,93,87,136,149,167,138,45,21,72,90,187,128,42,57,37,121,162,126,143,160,6,1,33,124,94,10,36,182,140,34,147,23,189,81,0,85,104,31,74,20,19,144,170,95,38,139,165,46,51,50,146,118,174,123,82,67,32,91,163,25,70,65,16,190,11,113,156,71,8,184,84,191,173,18,12,110,101,59,80,131,30,134,148,195,97,58,175,151,7,102,181,68,4,142,137,158,54,52,119,49,39,107,55,14,13,111,112,89,75,154,15,135,53,183,69,159,164,9,28,155,73,99,106,194,115,152,35,161,172,86,133,76,122,116,44,125,145,56,92,108,192,40,169,129,29,78,60,177,27,43,127,96,171,141,98,114,64,79,179,47,88,5,186,199,83,153,166,24,150,100,185,62,120,197,168,17,48,63];608;False
1959;8074;10033;[41,32,14,28,166,5,27,197,150,105,99,73,140,178,192,10,123,17,8,94,173,18,158,160,156,162,15,135,154,49,195,117,182,65,124,147,130,22,38,139,72,1,75,151,7,153,187,127,39,107,76,122,102,114,101,110,30,134,137,86,181,82,67,12,54,142,121,168,3,98,129,2,81,52,174,118,183,83,26,79,185,148,167,61,59,36,9,93,23,133,96,157,138,45,188,87,66,126,20,146,50,53,51,29,71,55,106,194,56,190,43,128,85,164,69,159,40,37,145,189,33,13,172,111,25,109,141,35,4,91,180,88,78,171,152,57,186,113,196,89,24,198,92,74,143,97,131,0,199,62,44,34,108,6,21,155,184,161,80,58,177,169,191,11,104,46,163,170,95,31,90,125,149,120,68,63,100,116,175,176,193,16,136,144,70,19,64,103,112,84,77,115,179,60,42,47,132,165,119,48];609;True
3906;6970;10876;[180,196,130,22,26,93,178,117,2,41,3,176,77,132,193,109,66,157,103,105,198,188,61,87,136,149,167,138,45,21,72,90,187,128,42,57,37,121,162,126,143,160,6,1,33,124,94,10,36,182,140,34,147,23,189,81,0,85,104,31,74,20,19,144,170,95,38,139,165,46,51,50,146,118,174,123,82,67,32,91,163,25,70,65,16,190,11,113,156,71,8,184,84,191,173,18,12,110,101,59,80,131,30,134,148,195,97,58,175,151,7,102,181,68,4,142,137,158,54,52,119,49,39,107,55,14,13,111,112,89,75,154,15,135,53,183,69,159,164,9,28,155,73,99,106,194,115,152,35,161,172,86,133,76,122,116,44,125,145,56,92,108,192,40,169,129,29,78,60,177,27,43,127,96,171,141,98,114,64,79,179,47,88,5,186,199,83,153,166,24,150,100,185,62,120,197,168,17,48,63];610;True
1998;8065;10063;[154,32,14,28,166,5,27,197,150,105,99,73,140,178,192,10,123,17,8,94,173,18,158,160,156,162,15,135,41,49,195,117,182,65,124,147,130,22,38,139,72,1,75,151,7,153,187,127,39,107,76,122,102,114,101,110,30,134,137,86,181,82,67,12,54,142,121,168,3,98,129,2,81,52,174,118,183,83,26,79,185,148,167,61,59,36,9,93,23,133,96,157,138,45,188,87,66,126,20,146,50,53,51,29,71,55,106,194,56,190,43,128,85,164,69,159,40,37,145,189,33,13,172,111,25,109,141,35,4,91,180,88,78,171,152,57,186,113,196,89,24,198,92,74,143,97,131,0,199,62,44,34,108,6,21,155,184,161,80,58,177,169,191,11,104,46,163,170,95,31,90,125,149,120,68,63,100,116,175,176,193,16,136,144,70,19,64,103,112,84,77,115,179,60,42,47,132,165,119,48];611;True
3874;6972;10846;[174,196,130,22,26,93,178,117,2,41,3,176,77,132,193,109,66,157,103,105,198,188,61,87,136,149,167,138,45,21,72,90,187,128,42,57,37,121,162,126,143,160,6,1,33,124,94,10,36,182,140,34,147,23,189,81,0,85,104,31,74,20,19,144,170,95,38,139,165,46,51,50,146,118,180,123,82,67,32,91,163,25,70,65,16,190,11,113,156,71,8,184,84,191,173,18,12,110,101,59,80,131,30,134,148,195,97,58,175,151,7,102,181,68,4,142,137,158,54,52,119,49,39,107,55,14,13,111,112,89,75,154,15,135,53,183,69,159,164,9,28,155,73,99,106,194,115,152,35,161,172,86,133,76,122,116,44,125,145,56,92,108,192,40,169,129,29,78,60,177,27,43,127,96,171,141,98,114,64,79,179,47,88,5,186,199,83,153,166,24,150,100,185,62,120,197,168,17,48,63];612;True
2055;8039;10094;[180,32,14,28,166,5,27,197,150,105,99,73,140,178,192,10,123,17,8,94,173,18,158,160,156,162,15,135,41,49,195,117,182,65,124,147,130,22,38,139,72,1,75,151,7,153,187,127,39,107,76,122,102,114,101,110,30,134,137,86,181,82,67,12,54,142,121,168,3,98,129,2,81,52,174,118,183,83,26,79,185,148,167,61,59,36,9,93,23,133,96,157,138,45,188,87,66,126,20,146,50,53,51,29,71,55,106,194,56,190,43,128,85,164,69,159,40,37,145,189,33,13,172,111,25,109,141,35,4,91,154,88,78,171,152,57,186,113,196,89,24,198,92,74,143,97,131,0,199,62,44,34,108,6,21,155,184,161,80,58,177,169,191,11,104,46,163,170,95,31,90,125,149,120,68,63,100,116,175,176,193,16,136,144,70,19,64,103,112,84,77,115,179,60,42,47,132,165,119,48];613;True
3866;6974;10840;[174,160,130,22,26,93,178,117,2,41,3,176,77,132,193,109,66,157,103,105,198,188,61,87,136,149,167,138,45,21,72,90,187,128,42,57,37,121,162,126,143,196,6,1,33,124,94,10,36,182,140,34,147,23,189,81,0,85,104,31,74,20,19,144,170,95,38,139,165,46,51,50,146,118,180,123,82,67,32,91,163,25,70,65,16,190,11,113,156,71,8,184,84,191,173,18,12,110,101,59,80,131,30,134,148,195,97,58,175,151,7,102,181,68,4,142,137,158,54,52,119,49,39,107,55,14,13,111,112,89,75,154,15,135,53,183,69,159,164,9,28,155,73,99,106,194,115,152,35,161,172,86,133,76,122,116,44,125,145,56,92,108,192,40,169,129,29,78,60,177,27,43,127,96,171,141,98,114,64,79,179,47,88,5,186,199,83,153,166,24,150,100,185,62,120,197,168,17,48,63];614;True
2008;8050;10058;[147,32,14,28,166,5,27,197,150,105,99,73,140,178,192,10,123,17,8,94,173,18,158,160,156,162,15,135,41,49,195,117,182,65,124,180,130,22,38,139,72,1,75,151,7,153,187,127,39,107,76,122,102,114,101,110,30,134,137,86,181,82,67,12,54,142,121,168,3,98,129,2,81,52,174,118,183,83,26,79,185,148,167,61,59,36,9,93,23,133,96,157,138,45,188,87,66,126,20,146,50,53,51,29,71,55,106,194,56,190,43,128,85,164,69,159,40,37,145,189,33,13,172,111,25,109,141,35,4,91,154,88,78,171,152,57,186,113,196,89,24,198,92,74,143,97,131,0,199,62,44,34,108,6,21,155,184,161,80,58,177,169,191,11,104,46,163,170,95,31,90,125,149,120,68,63,100,116,175,176,193,16,136,144,70,19,64,103,112,84,77,115,179,60,42,47,132,165,119,48];615;True
3856;6977;10833;[174,138,130,22,26,93,178,117,2,41,3,176,77,132,193,109,66,157,103,105,198,188,61,87,136,149,167,160,45,21,72,90,187,128,42,57,37,121,162,126,143,196,6,1,33,124,94,10,36,182,140,34,147,23,189,81,0,85,104,31,74,20,19,144,170,95,38,139,165,46,51,50,146,118,180,123,82,67,32,91,163,25,70,65,16,190,11,113,156,71,8,184,84,191,173,18,12,110,101,59,80,131,30,134,148,195,97,58,175,151,7,102,181,68,4,142,137,158,54,52,119,49,39,107,55,14,13,111,112,89,75,154,15,135,53,183,69,159,164,9,28,155,73,99,106,194,115,152,35,161,172,86,133,76,122,116,44,125,145,56,92,108,192,40,169,129,29,78,60,177,27,43,127,96,171,141,98,114,64,79,179,47,88,5,186,199,83,153,166,24,150,100,185,62,120,197,168,17,48,63];616;True
2092;8034;10126;[90,32,14,28,166,5,27,197,150,105,99,73,140,178,192,10,123,17,8,94,173,18,158,160,156,162,15,135,41,49,195,117,182,65,124,180,130,22,38,139,72,1,75,151,7,153,187,127,39,107,76,122,102,114,101,110,30,134,137,86,181,82,67,12,54,142,121,168,3,98,129,2,81,52,174,118,183,83,26,79,185,148,167,61,59,36,9,93,23,133,96,157,138,45,188,87,66,126,20,146,50,53,51,29,71,55,106,194,56,190,43,128,85,164,69,159,40,37,145,189,33,13,172,111,25,109,141,35,4,91,154,88,78,171,152,57,186,113,196,89,24,198,92,74,143,97,131,0,199,62,44,34,108,6,21,155,184,161,80,58,177,169,191,11,104,46,163,170,95,31,147,125,149,120,68,63,100,116,175,176,193,16,136,144,70,19,64,103,112,84,77,115,179,60,42,47,132,165,119,48];617;True
